0 Grasp(Left, Needle):0	Grasp(Right, Needle):1	Grasp(Left, Needle):0	 ->Grasp(Left, Needle)
1 Grasp(Left, Needle):0	Grasp(Right, Needle):1	Grasp(Left, Needle):0	 ->Grasp(Left, Needle)
2 Grasp(Left, Needle):0	Grasp(Right, Needle):1	Grasp(Left, Needle):0	 ->Grasp(Left, Needle)
3 Grasp(Left, Needle):0	Grasp(Right, Needle):1	Grasp(Left, Needle):0	 ->Grasp(Left, Needle)
4 Grasp(Left, Needle):0	Grasp(Right, Needle):1	Grasp(Left, Needle):0	 ->Grasp(Left, Needle)
5 Grasp(Left, Needle):0	Grasp(Right, Needle):1	Grasp(Left, Needle):0	 ->Grasp(Left, Needle)
6 Grasp(Left, Needle):0	Grasp(Right, Needle):1	Grasp(Left, Needle):0	 ->Grasp(Left, Needle)
7 Grasp(Left, Needle):0	Grasp(Right, Needle):1	Grasp(Left, Needle):0	 ->Grasp(Left, Needle)
8 Grasp(Left, Needle):0	Grasp(Right, Needle):1	Grasp(Left, Needle):0	 ->Grasp(Left, Needle)
9 Grasp(Left, Needle):0	Grasp(Right, Needle):1	Grasp(Left, Needle):0	 ->Grasp(Left, Needle)
10 Grasp(Left, Needle):0	Grasp(Right, Needle):1	Grasp(Left, Needle):0	 ->Grasp(Left, Needle)
11 Grasp(Left, Needle):0	Grasp(Right, Needle):1	Grasp(Left, Needle):0	 ->Grasp(Left, Needle)
12 Grasp(Left, Needle):0	Grasp(Right, Needle):1	Grasp(Left, Needle):0	 ->Grasp(Left, Needle)
13 Grasp(Left, Needle):0	Grasp(Right, Needle):1	Grasp(Left, Needle):0	 ->Grasp(Left, Needle)
14 Grasp(Left, Needle):0	Grasp(Right, Needle):1	Grasp(Left, Needle):0	 ->Grasp(Left, Needle)
15 Grasp(Left, Needle):0	Grasp(Right, Needle):1	Grasp(Left, Needle):0	 ->Grasp(Left, Needle)
16 Grasp(Left, Needle):0	Grasp(Right, Needle):1	Grasp(Left, Needle):0	 ->Grasp(Left, Needle)
17 Grasp(Left, Needle):0	Grasp(Right, Needle):1	Grasp(Left, Needle):0	 ->Grasp(Left, Needle)
18 Grasp(Left, Needle):0	Grasp(Right, Needle):1	Grasp(Left, Needle):0	 ->Grasp(Left, Needle)
19 Grasp(Left, Needle):0	Grasp(Right, Needle):1	Grasp(Left, Needle):0	 ->Grasp(Left, Needle)
20 Grasp(Left, Needle):0	Grasp(Right, Needle):1	Grasp(Left, Needle):0	 ->Grasp(Left, Needle)
21 Grasp(Left, Needle):0	Grasp(Right, Needle):1	Grasp(Left, Needle):0	 ->Grasp(Left, Needle)
22 Grasp(Left, Needle):0	Grasp(Right, Needle):1	Grasp(Left, Needle):0	 ->Grasp(Left, Needle)
23 Grasp(Left, Needle):0	Grasp(Right, Needle):1	Grasp(Left, Needle):0	 ->Grasp(Left, Needle)
24 Grasp(Left, Needle):0	Grasp(Right, Needle):1	Grasp(Left, Needle):0	 ->Grasp(Left, Needle)
25 Grasp(Left, Needle):0	Grasp(Right, Needle):1	Grasp(Left, Needle):0	 ->Grasp(Left, Needle)
26 Grasp(Left, Needle):0	Grasp(Right, Needle):1	Grasp(Left, Needle):0	 ->Grasp(Left, Needle)
27 Grasp(Left, Needle):0	Grasp(Right, Needle):1	Grasp(Left, Needle):0	 ->Grasp(Left, Needle)
28 Grasp(Left, Needle):0	Grasp(Right, Needle):1	Grasp(Left, Needle):0	 ->Grasp(Left, Needle)
29 Grasp(Left, Needle):0	Grasp(Right, Needle):1	Grasp(Left, Needle):0	 ->Grasp(Left, Needle)
30 Grasp(Left, Needle):0	Grasp(Right, Needle):1	Grasp(Left, Needle):0	 ->Grasp(Left, Needle)
31 Grasp(Left, Needle):0	Grasp(Right, Needle):1	Grasp(Left, Needle):0	 ->Grasp(Left, Needle)
32 Grasp(Left, Needle):0	Grasp(Right, Needle):1	Grasp(Left, Needle):0	 ->Grasp(Left, Needle)
33 Grasp(Left, Needle):0	Grasp(Right, Needle):1	Grasp(Left, Needle):0	 ->Grasp(Left, Needle)
34 Grasp(Left, Needle):0	Grasp(Right, Needle):1	Grasp(Left, Needle):0	 ->Grasp(Left, Needle)
35 Grasp(Left, Needle):0	Grasp(Right, Needle):1	Grasp(Left, Needle):0	 ->Grasp(Left, Needle)
36 Grasp(Left, Needle):0	Grasp(Right, Needle):1	Grasp(Left, Needle):0	 ->Grasp(Left, Needle)
37 Grasp(Left, Needle):0	Grasp(Right, Needle):1	Grasp(Left, Needle):0	 ->Grasp(Left, Needle)
38 Grasp(Left, Needle):0	Grasp(Right, Needle):1	Grasp(Left, Needle):0	 ->Grasp(Left, Needle)
39 Grasp(Left, Needle):0	Grasp(Right, Needle):1	Grasp(Left, Needle):0	 ->Grasp(Left, Needle)
40 Grasp(Left, Needle):0	Grasp(Right, Needle):1	Grasp(Left, Needle):0	 ->Grasp(Left, Needle)
41 Grasp(Left, Needle):0	Grasp(Right, Needle):1	Grasp(Left, Needle):0	 ->Grasp(Left, Needle)
42 Grasp(Left, Needle):0	Grasp(Right, Needle):1	Grasp(Left, Needle):0	 ->Grasp(Left, Needle)
43 Grasp(Left, Needle):0	Grasp(Right, Needle):1	Grasp(Left, Needle):0	 ->Grasp(Left, Needle)
44 Grasp(Left, Needle):0	Grasp(Right, Needle):1	Grasp(Left, Needle):0	 ->Grasp(Left, Needle)
45 Grasp(Left, Needle):0	Grasp(Right, Needle):1	Grasp(Left, Needle):0	 ->Grasp(Left, Needle)
46 Grasp(Left, Needle):0	Grasp(Right, Needle):1	Grasp(Left, Needle):0	 ->Grasp(Left, Needle)
47 Grasp(Left, Needle):0	Grasp(Right, Needle):1	Grasp(Left, Needle):0	 ->Grasp(Left, Needle)
48 Grasp(Left, Needle):0	Grasp(Right, Needle):1	Grasp(Left, Needle):0	 ->Grasp(Left, Needle)
49 Grasp(Left, Needle):0	Grasp(Right, Needle):1	Grasp(Left, Needle):0	 ->Grasp(Left, Needle)
50 Grasp(Left, Needle):0	Grasp(Right, Needle):1	Grasp(Left, Needle):0	 ->Grasp(Left, Needle)
51 Grasp(Left, Needle):0	Grasp(Right, Needle):1	Grasp(Left, Needle):0	 ->Grasp(Left, Needle)
52 Grasp(Left, Needle):0	Grasp(Right, Needle):1	Grasp(Left, Needle):0	 ->Grasp(Left, Needle)
53 Grasp(Left, Needle):0	Grasp(Right, Needle):1	Grasp(Left, Needle):0	 ->Grasp(Left, Needle)
54 Grasp(Left, Needle):0	Grasp(Right, Needle):1	Grasp(Left, Needle):0	 ->Grasp(Left, Needle)
55 Grasp(Left, Needle):0	Grasp(Right, Needle):1	Grasp(Left, Needle):0	 ->Grasp(Left, Needle)
56 Grasp(Left, Needle):0	Grasp(Right, Needle):1	Grasp(Left, Needle):0	 ->Grasp(Left, Needle)
57 Grasp(Left, Needle):0	Grasp(Right, Needle):1	Grasp(Left, Needle):0	 ->Grasp(Left, Needle)
58 Grasp(Left, Needle):0	Grasp(Right, Needle):1	Grasp(Left, Needle):0	 ->Grasp(Left, Needle)
59 Grasp(Left, Needle):0	Grasp(Right, Needle):1	Grasp(Left, Needle):0	 ->Grasp(Left, Needle)
60 Grasp(Left, Needle):0	Grasp(Right, Needle):1	Grasp(Left, Needle):0	 ->Grasp(Left, Needle)
61 Grasp(Left, Needle):0	Grasp(Right, Needle):1	Grasp(Left, Needle):0	 ->Grasp(Left, Needle)
62 Grasp(Left, Needle):0	Grasp(Right, Needle):1	Grasp(Left, Needle):0	 ->Grasp(Left, Needle)
63 Grasp(Left, Needle):0	Grasp(Right, Needle):1	Grasp(Left, Needle):0	 ->Grasp(Left, Needle)
64 Grasp(Left, Needle):0	Grasp(Right, Needle):1	Grasp(Left, Needle):0	 ->Grasp(Left, Needle)
65 Grasp(Left, Needle):0	Grasp(Right, Needle):1	Grasp(Left, Needle):0	 ->Grasp(Left, Needle)
66 Grasp(Left, Needle):0	Grasp(Right, Needle):1	Grasp(Left, Needle):0	 ->Grasp(Left, Needle)
67 Grasp(Left, Needle):0	Grasp(Right, Needle):1	Grasp(Left, Needle):0	 ->Grasp(Left, Needle)
68 Grasp(Left, Needle):0	Grasp(Right, Needle):1	Grasp(Left, Needle):0	 ->Grasp(Left, Needle)
69 Grasp(Left, Needle):0	Grasp(Right, Needle):1	Grasp(Left, Needle):0	 ->Grasp(Left, Needle)
70 Grasp(Left, Needle):0	Grasp(Right, Needle):1	Grasp(Left, Needle):0	 ->Grasp(Left, Needle)
71 Grasp(Left, Needle):0	Grasp(Right, Needle):1	Grasp(Left, Needle):0	 ->Grasp(Left, Needle)
72 Grasp(Left, Needle):0	Grasp(Right, Needle):1	Grasp(Left, Needle):0	 ->Grasp(Left, Needle)
73 Grasp(Left, Needle):0	Grasp(Right, Needle):1	Grasp(Left, Needle):0	 ->Grasp(Left, Needle)
74 Grasp(Left, Needle):0	Grasp(Right, Needle):1	Grasp(Left, Needle):0	 ->Grasp(Left, Needle)
75 Grasp(Left, Needle):0	Grasp(Right, Needle):1	Grasp(Left, Needle):0	 ->Grasp(Left, Needle)
76 Grasp(Left, Needle):0	Grasp(Right, Needle):1	Grasp(Left, Needle):0	 ->Grasp(Left, Needle)
77 Grasp(Left, Needle):0	Grasp(Right, Needle):1	Grasp(Left, Needle):0	 ->Grasp(Left, Needle)
78 Grasp(Left, Needle):0	Grasp(Right, Needle):1	Grasp(Left, Needle):0	 ->Grasp(Left, Needle)
79 Grasp(Left, Needle):0	Grasp(Right, Needle):1	Grasp(Left, Needle):0	 ->Grasp(Left, Needle)
80 Grasp(Left, Needle):0	Grasp(Right, Needle):1	Grasp(Left, Needle):0	 ->Grasp(Left, Needle)
81 Grasp(Left, Needle):0	Grasp(Right, Needle):1	Grasp(Left, Needle):0	 ->Grasp(Left, Needle)
82 Grasp(Left, Needle):0	Grasp(Right, Needle):1	Grasp(Left, Needle):0	 ->Grasp(Left, Needle)
83 Grasp(Left, Needle):0	Grasp(Right, Needle):1	Grasp(Left, Needle):0	 ->Grasp(Left, Needle)
84 Grasp(Left, Needle):0	Grasp(Right, Needle):1	Grasp(Left, Needle):0	 ->Grasp(Left, Needle)
85 Grasp(Left, Needle):0	Grasp(Right, Needle):1	Grasp(Left, Needle):0	 ->Grasp(Left, Needle)
86 Grasp(Left, Needle):0	Grasp(Right, Needle):1	Grasp(Left, Needle):0	 ->Grasp(Left, Needle)
87 Grasp(Left, Needle):0	Grasp(Right, Needle):1	Grasp(Left, Needle):0	 ->Grasp(Left, Needle)
88 Grasp(Left, Needle):0	Grasp(Right, Needle):1	Grasp(Left, Needle):0	 ->Grasp(Left, Needle)
89 Grasp(Left, Needle):0	Grasp(Right, Needle):1	Grasp(Left, Needle):0	 ->Grasp(Left, Needle)
90 Grasp(Left, Needle):0	Grasp(Right, Needle):1	Grasp(Left, Needle):0	 ->Grasp(Left, Needle)
91 Grasp(Left, Needle):0	Grasp(Right, Needle):1	Grasp(Left, Needle):0	 ->Grasp(Left, Needle)
92 Grasp(Left, Needle):0	Grasp(Right, Needle):1	Grasp(Left, Needle):0	 ->Grasp(Left, Needle)
93 Grasp(Left, Needle):0	Grasp(Right, Needle):1	Grasp(Left, Needle):0	 ->Grasp(Left, Needle)
94 Grasp(Left, Needle):0	Grasp(Right, Needle):1	Grasp(Left, Needle):0	 ->Grasp(Left, Needle)
95 Grasp(Left, Needle):0	Grasp(Right, Needle):1	Grasp(Left, Needle):0	 ->Grasp(Left, Needle)
96 Grasp(Left, Needle):0	Grasp(Right, Needle):1	Grasp(Left, Needle):0	 ->Grasp(Left, Needle)
97 Grasp(Left, Needle):0	Grasp(Right, Needle):1	Grasp(Left, Needle):0	 ->Grasp(Left, Needle)
98 Grasp(Left, Needle):0	Grasp(Right, Needle):1	Grasp(Left, Needle):0	 ->Grasp(Left, Needle)
99 Grasp(Left, Needle):0	Grasp(Right, Needle):1	Grasp(Left, Needle):0	 ->Grasp(Left, Needle)
100 Grasp(Left, Needle):0	Grasp(Right, Needle):1	Grasp(Left, Needle):0	 ->Grasp(Left, Needle)
101 Grasp(Left, Needle):0	Grasp(Right, Needle):1	Grasp(Left, Needle):0	 ->Grasp(Left, Needle)
102 Grasp(Left, Needle):0	Grasp(Right, Needle):1	Grasp(Left, Needle):0	 ->Grasp(Left, Needle)
103 Grasp(Left, Needle):0	Grasp(Right, Needle):1	Grasp(Left, Needle):0	 ->Grasp(Left, Needle)
104 Grasp(Left, Needle):0	Grasp(Right, Needle):1	Grasp(Left, Needle):0	 ->Grasp(Left, Needle)
105 Grasp(Left, Needle):0	Grasp(Right, Needle):1	Grasp(Left, Needle):0	 ->Grasp(Left, Needle)
106 Grasp(Left, Needle):0	Grasp(Right, Needle):1	Grasp(Left, Needle):0	 ->Grasp(Left, Needle)
107 Grasp(Left, Needle):0	Grasp(Right, Needle):1	Grasp(Left, Needle):0	 ->Grasp(Left, Needle)
108 Grasp(Left, Needle):0	Grasp(Right, Needle):1	Grasp(Left, Needle):0	 ->Grasp(Left, Needle)
109 Grasp(Left, Needle):0	Grasp(Right, Needle):1	Grasp(Left, Needle):0	 ->Grasp(Left, Needle)
110 Grasp(Left, Needle):0	Grasp(Right, Needle):1	Grasp(Left, Needle):0	 ->Grasp(Left, Needle)
111 Grasp(Left, Needle):0	Grasp(Right, Needle):1	Release(Right, Needle):2	 ->Grasp(Left, Needle)
112 Grasp(Left, Needle):0	Grasp(Right, Needle):1	Release(Right, Needle):2	 ->Grasp(Left, Needle)
113 Grasp(Left, Needle):0	Grasp(Left, Needle):0	Release(Right, Needle):2	 ->Grasp(Left, Needle)
114 Grasp(Left, Needle):0	Grasp(Left, Needle):0	Release(Right, Needle):2	 ->Grasp(Left, Needle)
115 Grasp(Left, Needle):0	Grasp(Left, Needle):0	Release(Right, Needle):2	 ->Grasp(Left, Needle)
116 Grasp(Left, Needle):0	Grasp(Left, Needle):0	Release(Right, Needle):2	 ->Grasp(Left, Needle)
117 Grasp(Left, Needle):0	Grasp(Left, Needle):0	Release(Right, Needle):2	 ->Grasp(Left, Needle)
118 Grasp(Left, Needle):0	Release(Right, Needle):2	Untouch(Right, Needle):3	 ->Grasp(Left, Needle)
119 Grasp(Left, Needle):0	Release(Right, Needle):2	Untouch(Right, Needle):3	 ->Grasp(Left, Needle)
120 Grasp(Left, Needle):0	Release(Right, Needle):2	Untouch(Right, Needle):3	 ->Grasp(Left, Needle)
121 Grasp(Right, Needle):1	Release(Right, Needle):2	Untouch(Right, Needle):3	 ->Grasp(Right, Needle)
122 Grasp(Right, Needle):1	Release(Right, Needle):2	Untouch(Right, Needle):3	 ->Grasp(Right, Needle)
123 Grasp(Right, Needle):1	Release(Right, Needle):2	Untouch(Right, Needle):3	 ->Grasp(Right, Needle)
124 Grasp(Right, Needle):1	Release(Right, Needle):2	Untouch(Right, Needle):3	 ->Grasp(Right, Needle)
125 Grasp(Right, Needle):1	Release(Right, Needle):2	Untouch(Right, Needle):3	 ->Grasp(Right, Needle)
126 Grasp(Right, Needle):1	Release(Right, Needle):2	Touch(Right, Needle):4	 ->Grasp(Right, Needle)
127 Grasp(Right, Needle):1	Release(Right, Needle):2	Touch(Right, Needle):4	 ->Grasp(Right, Needle)
128 Grasp(Right, Needle):1	Release(Right, Needle):2	Touch(Right, Needle):4	 ->Grasp(Right, Needle)
129 Grasp(Right, Needle):1	Release(Right, Needle):2	Touch(Right, Needle):4	 ->Grasp(Right, Needle)
130 Grasp(Right, Needle):1	Release(Right, Needle):2	Touch(Right, Needle):4	 ->Grasp(Right, Needle)
131 Grasp(Right, Needle):1	Release(Right, Needle):2	Touch(Right, Needle):4	 ->Grasp(Right, Needle)
132 Grasp(Right, Needle):1	Release(Right, Needle):2	Touch(Right, Needle):4	 ->Grasp(Right, Needle)
133 Grasp(Right, Needle):1	Release(Right, Needle):2	Touch(Right, Needle):4	 ->Grasp(Right, Needle)
134 Grasp(Right, Needle):1	Release(Right, Needle):2	Touch(Right, Needle):4	 ->Grasp(Right, Needle)
135 Grasp(Right, Needle):1	Release(Right, Needle):2	Touch(Right, Needle):4	 ->Grasp(Right, Needle)
136 Grasp(Right, Needle):1	Release(Right, Needle):2	Touch(Right, Needle):4	 ->Grasp(Right, Needle)
137 Grasp(Right, Needle):1	Release(Right, Needle):2	Touch(Right, Needle):4	 ->Grasp(Right, Needle)
138 Grasp(Right, Needle):1	Release(Right, Needle):2	Touch(Right, Needle):4	 ->Grasp(Right, Needle)
139 Grasp(Right, Needle):1	Release(Right, Needle):2	Touch(Right, Needle):4	 ->Grasp(Right, Needle)
140 Grasp(Right, Needle):1	Release(Right, Needle):2	Touch(Right, Needle):4	 ->Grasp(Right, Needle)
141 Grasp(Right, Needle):1	Release(Right, Needle):2	Touch(Right, Needle):4	 ->Grasp(Right, Needle)
142 Grasp(Right, Needle):1	Release(Right, Needle):2	Touch(Right, Needle):4	 ->Grasp(Right, Needle)
143 Grasp(Right, Needle):1	Release(Right, Needle):2	Touch(Right, Needle):4	 ->Grasp(Right, Needle)
144 Grasp(Right, Needle):1	Release(Right, Needle):2	Touch(Right, Needle):4	 ->Grasp(Right, Needle)
145 Grasp(Right, Needle):1	Release(Right, Needle):2	Touch(Right, Needle):4	 ->Grasp(Right, Needle)
146 Grasp(Right, Needle):1	Release(Right, Needle):2	Touch(Right, Needle):4	 ->Grasp(Right, Needle)
147 Grasp(Right, Needle):1	Release(Right, Needle):2	Touch(Right, Needle):4	 ->Grasp(Right, Needle)
148 Grasp(Right, Needle):1	Release(Right, Needle):2	Touch(Right, Needle):4	 ->Grasp(Right, Needle)
149 Grasp(Right, Needle):1	Release(Right, Needle):2	Touch(Right, Needle):4	 ->Grasp(Right, Needle)
150 Grasp(Right, Needle):1	Release(Right, Needle):2	Touch(Right, Needle):4	 ->Grasp(Right, Needle)
151 Grasp(Right, Needle):1	Release(Right, Needle):2	Touch(Right, Needle):4	 ->Grasp(Right, Needle)
152 Grasp(Right, Needle):1	Release(Right, Needle):2	Touch(Right, Needle):4	 ->Grasp(Right, Needle)
153 Grasp(Right, Needle):1	Release(Right, Needle):2	Grasp(Right, Needle):1	 ->Grasp(Right, Needle)
154 Grasp(Right, Needle):1	Release(Right, Needle):2	Grasp(Right, Needle):1	 ->Grasp(Right, Needle)
155 Grasp(Right, Needle):1	Release(Right, Needle):2	Grasp(Right, Needle):1	 ->Grasp(Right, Needle)
156 Grasp(Right, Needle):1	Release(Right, Needle):2	Grasp(Right, Needle):1	 ->Grasp(Right, Needle)
157 Grasp(Right, Needle):1	Release(Right, Needle):2	Grasp(Right, Needle):1	 ->Grasp(Right, Needle)
158 Grasp(Right, Needle):1	Release(Right, Needle):2	Grasp(Right, Needle):1	 ->Grasp(Right, Needle)
159 Grasp(Right, Needle):1	Release(Right, Needle):2	Grasp(Right, Needle):1	 ->Grasp(Right, Needle)
160 Grasp(Right, Needle):1	Release(Right, Needle):2	Grasp(Right, Needle):1	 ->Grasp(Right, Needle)
161 Grasp(Right, Needle):1	Release(Right, Needle):2	Grasp(Right, Needle):1	 ->Grasp(Right, Needle)
162 Grasp(Right, Needle):1	Release(Right, Needle):2	Grasp(Right, Needle):1	 ->Grasp(Right, Needle)
163 Grasp(Right, Needle):1	Release(Right, Needle):2	Grasp(Right, Needle):1	 ->Grasp(Right, Needle)
164 Grasp(Right, Needle):1	Release(Right, Needle):2	Release(Left, Needle):5	 ->Grasp(Right, Needle)
165 Grasp(Right, Needle):1	Grasp(Right, Needle):1	Release(Left, Needle):5	 ->Grasp(Right, Needle)
166 Grasp(Right, Needle):1	Grasp(Right, Needle):1	Release(Left, Needle):5	 ->Grasp(Right, Needle)
167 Grasp(Right, Needle):1	Grasp(Right, Needle):1	Release(Left, Needle):5	 ->Grasp(Right, Needle)
168 Grasp(Right, Needle):1	Grasp(Right, Needle):1	Release(Left, Needle):5	 ->Grasp(Right, Needle)
169 Grasp(Right, Needle):1	Grasp(Right, Needle):1	Release(Left, Needle):5	 ->Grasp(Right, Needle)
170 Grasp(Right, Needle):1	Grasp(Right, Needle):1	Release(Left, Needle):5	 ->Grasp(Right, Needle)
171 Grasp(Right, Needle):1	Grasp(Right, Needle):1	Untouch(Left, Needle):6	 ->Grasp(Right, Needle)
172 Grasp(Right, Needle):1	Grasp(Right, Needle):1	Untouch(Left, Needle):6	 ->Grasp(Right, Needle)
173 Grasp(Right, Needle):1	Release(Left, Needle):5	Untouch(Left, Needle):6	 ->Grasp(Right, Needle)
174 Grasp(Right, Needle):1	Release(Left, Needle):5	Push(Right, Needle):7	 ->Grasp(Right, Needle)
175 Grasp(Right, Needle):1	Release(Left, Needle):5	Push(Right, Needle):7	 ->Grasp(Right, Needle)
176 Grasp(Right, Needle):1	Release(Left, Needle):5	Push(Right, Needle):7	 ->Grasp(Right, Needle)
177 Grasp(Right, Needle):1	Release(Left, Needle):5	Push(Right, Needle):7	 ->Grasp(Right, Needle)
178 Grasp(Right, Needle):1	Release(Left, Needle):5	Push(Right, Needle):7	 ->Grasp(Right, Needle)
179 Grasp(Right, Needle):1	Release(Left, Needle):5	Push(Right, Needle):7	 ->Grasp(Right, Needle)
180 Grasp(Right, Needle):1	Release(Left, Needle):5	Push(Right, Needle):7	 ->Grasp(Right, Needle)
181 Grasp(Right, Needle):1	Release(Left, Needle):5	Push(Right, Needle):7	 ->Grasp(Right, Needle)
182 Grasp(Right, Needle):1	Release(Left, Needle):5	Push(Right, Needle):7	 ->Grasp(Right, Needle)
183 Grasp(Right, Needle):1	Release(Left, Needle):5	Push(Right, Needle):7	 ->Grasp(Right, Needle)
184 Grasp(Right, Needle):1	Release(Left, Needle):5	Push(Right, Needle):7	 ->Grasp(Right, Needle)
185 Push(Right, Needle):7	Release(Left, Needle):5	Push(Right, Needle):7	 ->Push(Right, Needle)
186 Push(Right, Needle):7	Release(Left, Needle):5	Push(Right, Needle):7	 ->Push(Right, Needle)
187 Push(Right, Needle):7	Release(Left, Needle):5	Push(Right, Needle):7	 ->Push(Right, Needle)
188 Push(Right, Needle):7	Release(Left, Needle):5	Push(Right, Needle):7	 ->Push(Right, Needle)
189 Push(Right, Needle):7	Release(Left, Needle):5	Push(Right, Needle):7	 ->Push(Right, Needle)
190 Push(Right, Needle):7	Release(Left, Needle):5	Push(Right, Needle):7	 ->Push(Right, Needle)
191 Push(Right, Needle):7	Release(Left, Needle):5	Push(Right, Needle):7	 ->Push(Right, Needle)
192 Push(Right, Needle):7	Release(Left, Needle):5	Push(Right, Needle):7	 ->Push(Right, Needle)
193 Push(Right, Needle):7	Release(Left, Needle):5	Push(Right, Needle):7	 ->Push(Right, Needle)
194 Push(Right, Needle):7	Release(Left, Needle):5	Push(Right, Needle):7	 ->Push(Right, Needle)
195 Push(Right, Needle):7	Release(Left, Needle):5	Push(Right, Needle):7	 ->Push(Right, Needle)
196 Push(Right, Needle):7	Release(Left, Needle):5	Push(Right, Needle):7	 ->Push(Right, Needle)
197 Push(Right, Needle):7	Release(Left, Needle):5	Push(Right, Needle):7	 ->Push(Right, Needle)
198 Push(Right, Needle):7	Release(Left, Needle):5	Push(Right, Needle):7	 ->Push(Right, Needle)
199 Push(Right, Needle):7	Release(Left, Needle):5	Push(Right, Needle):7	 ->Push(Right, Needle)
200 Push(Right, Needle):7	Release(Left, Needle):5	Push(Right, Needle):7	 ->Push(Right, Needle)
201 Push(Right, Needle):7	Release(Left, Needle):5	Push(Right, Needle):7	 ->Push(Right, Needle)
202 Push(Right, Needle):7	Release(Left, Needle):5	Push(Right, Needle):7	 ->Push(Right, Needle)
203 Push(Right, Needle):7	Release(Left, Needle):5	Push(Right, Needle):7	 ->Push(Right, Needle)
204 Push(Right, Needle):7	Release(Left, Needle):5	Push(Right, Needle):7	 ->Push(Right, Needle)
205 Push(Right, Needle):7	Release(Left, Needle):5	Push(Right, Needle):7	 ->Push(Right, Needle)
206 Push(Right, Needle):7	Release(Left, Needle):5	Push(Right, Needle):7	 ->Push(Right, Needle)
207 Push(Right, Needle):7	Release(Left, Needle):5	Push(Right, Needle):7	 ->Push(Right, Needle)
208 Push(Right, Needle):7	Release(Left, Needle):5	Push(Right, Needle):7	 ->Push(Right, Needle)
209 Push(Right, Needle):7	Release(Left, Needle):5	Push(Right, Needle):7	 ->Push(Right, Needle)
210 Push(Right, Needle):7	Release(Left, Needle):5	Push(Right, Needle):7	 ->Push(Right, Needle)
211 Push(Right, Needle):7	Release(Left, Needle):5	Push(Right, Needle):7	 ->Push(Right, Needle)
212 Push(Right, Needle):7	Release(Left, Needle):5	Push(Right, Needle):7	 ->Push(Right, Needle)
213 Push(Right, Needle):7	Release(Left, Needle):5	Push(Right, Needle):7	 ->Push(Right, Needle)
214 Push(Right, Needle):7	Release(Left, Needle):5	Push(Right, Needle):7	 ->Push(Right, Needle)
215 Push(Right, Needle):7	Release(Left, Needle):5	Push(Right, Needle):7	 ->Push(Right, Needle)
216 Push(Right, Needle):7	Release(Left, Needle):5	Push(Right, Needle):7	 ->Push(Right, Needle)
217 Push(Right, Needle):7	Release(Left, Needle):5	Push(Right, Needle):7	 ->Push(Right, Needle)
218 Push(Right, Needle):7	Release(Left, Needle):5	Push(Right, Needle):7	 ->Push(Right, Needle)
219 Push(Right, Needle):7	Release(Left, Needle):5	Push(Right, Needle):7	 ->Push(Right, Needle)
220 Push(Right, Needle):7	Release(Left, Needle):5	Push(Right, Needle):7	 ->Push(Right, Needle)
221 Push(Right, Needle):7	Release(Left, Needle):5	Push(Right, Needle):7	 ->Push(Right, Needle)
222 Push(Right, Needle):7	Release(Left, Needle):5	Push(Right, Needle):7	 ->Push(Right, Needle)
223 Push(Right, Needle):7	Release(Left, Needle):5	Push(Right, Needle):7	 ->Push(Right, Needle)
224 Push(Right, Needle):7	Release(Left, Needle):5	Push(Right, Needle):7	 ->Push(Right, Needle)
225 Push(Right, Needle):7	Release(Left, Needle):5	Push(Right, Needle):7	 ->Push(Right, Needle)
226 Push(Right, Needle):7	Release(Left, Needle):5	Push(Right, Needle):7	 ->Push(Right, Needle)
227 Push(Right, Needle):7	Release(Left, Needle):5	Push(Right, Needle):7	 ->Push(Right, Needle)
228 Push(Right, Needle):7	Release(Left, Needle):5	Push(Right, Needle):7	 ->Push(Right, Needle)
229 Push(Right, Needle):7	Release(Left, Needle):5	Push(Right, Needle):7	 ->Push(Right, Needle)
230 Push(Right, Needle):7	Release(Left, Needle):5	Push(Right, Needle):7	 ->Push(Right, Needle)
231 Push(Right, Needle):7	Release(Left, Needle):5	Push(Right, Needle):7	 ->Push(Right, Needle)
232 Push(Right, Needle):7	Release(Left, Needle):5	Push(Right, Needle):7	 ->Push(Right, Needle)
233 Push(Right, Needle):7	Release(Left, Needle):5	Push(Right, Needle):7	 ->Push(Right, Needle)
234 Push(Right, Needle):7	Release(Left, Needle):5	Push(Right, Needle):7	 ->Push(Right, Needle)
235 Push(Right, Needle):7	Release(Left, Needle):5	Push(Right, Needle):7	 ->Push(Right, Needle)
236 Push(Right, Needle):7	Release(Left, Needle):5	Push(Right, Needle):7	 ->Push(Right, Needle)
237 Push(Right, Needle):7	Release(Left, Needle):5	Push(Right, Needle):7	 ->Push(Right, Needle)
238 Push(Right, Needle):7	Release(Left, Needle):5	Push(Right, Needle):7	 ->Push(Right, Needle)
239 Push(Right, Needle):7	Release(Left, Needle):5	Push(Right, Needle):7	 ->Push(Right, Needle)
240 Push(Right, Needle):7	Release(Left, Needle):5	Push(Right, Needle):7	 ->Push(Right, Needle)
241 Push(Right, Needle):7	Release(Left, Needle):5	Push(Right, Needle):7	 ->Push(Right, Needle)
242 Push(Right, Needle):7	Touch(Needle, Fabric/Tissue):8	Push(Right, Needle):7	 ->Push(Right, Needle)
243 Push(Right, Needle):7	Touch(Needle, Fabric/Tissue):8	Push(Right, Needle):7	 ->Push(Right, Needle)
244 Push(Right, Needle):7	Touch(Needle, Fabric/Tissue):8	Push(Right, Needle):7	 ->Push(Right, Needle)
245 Push(Right, Needle):7	Touch(Needle, Fabric/Tissue):8	Push(Right, Needle):7	 ->Push(Right, Needle)
246 Push(Right, Needle):7	Push(Right, Needle):7	Push(Right, Needle):7	 ->Push(Right, Needle)
247 Push(Right, Needle):7	Push(Right, Needle):7	Push(Right, Needle):7	 ->Push(Right, Needle)
248 Push(Right, Needle):7	Push(Right, Needle):7	Push(Right, Needle):7	 ->Push(Right, Needle)
249 Push(Right, Needle):7	Push(Right, Needle):7	Push(Right, Needle):7	 ->Push(Right, Needle)
250 Push(Right, Needle):7	Push(Right, Needle):7	Push(Right, Needle):7	 ->Push(Right, Needle)
251 Push(Right, Needle):7	Push(Right, Needle):7	Push(Right, Needle):7	 ->Push(Right, Needle)
252 Push(Right, Needle):7	Push(Right, Needle):7	Push(Right, Needle):7	 ->Push(Right, Needle)
253 Push(Right, Needle):7	Push(Right, Needle):7	Push(Right, Needle):7	 ->Push(Right, Needle)
254 Push(Right, Needle):7	Push(Right, Needle):7	Push(Right, Needle):7	 ->Push(Right, Needle)
255 Push(Right, Needle):7	Push(Right, Needle):7	Push(Right, Needle):7	 ->Push(Right, Needle)
256 Push(Right, Needle):7	Push(Right, Needle):7	Push(Right, Needle):7	 ->Push(Right, Needle)
257 Push(Right, Needle):7	Push(Right, Needle):7	Push(Right, Needle):7	 ->Push(Right, Needle)
258 Push(Right, Needle):7	Push(Right, Needle):7	Push(Right, Needle):7	 ->Push(Right, Needle)
259 Push(Right, Needle):7	Push(Right, Needle):7	Push(Right, Needle):7	 ->Push(Right, Needle)
260 Push(Right, Needle):7	Push(Right, Needle):7	Push(Right, Needle):7	 ->Push(Right, Needle)
261 Push(Right, Needle):7	Push(Right, Needle):7	Push(Right, Needle):7	 ->Push(Right, Needle)
262 Push(Right, Needle):7	Push(Right, Needle):7	Push(Right, Needle):7	 ->Push(Right, Needle)
263 Push(Right, Needle):7	Push(Right, Needle):7	Push(Right, Needle):7	 ->Push(Right, Needle)
264 Push(Right, Needle):7	Push(Right, Needle):7	Push(Right, Needle):7	 ->Push(Right, Needle)
265 Push(Right, Needle):7	Push(Right, Needle):7	Push(Right, Needle):7	 ->Push(Right, Needle)
266 Push(Right, Needle):7	Push(Right, Needle):7	Push(Right, Needle):7	 ->Push(Right, Needle)
267 Push(Right, Needle):7	Push(Right, Needle):7	Push(Right, Needle):7	 ->Push(Right, Needle)
268 Push(Right, Needle):7	Push(Right, Needle):7	Push(Right, Needle):7	 ->Push(Right, Needle)
269 Push(Right, Needle):7	Push(Right, Needle):7	Push(Right, Needle):7	 ->Push(Right, Needle)
270 Push(Right, Needle):7	Push(Right, Needle):7	Push(Right, Needle):7	 ->Push(Right, Needle)
271 Push(Right, Needle):7	Push(Right, Needle):7	Push(Right, Needle):7	 ->Push(Right, Needle)
272 Push(Right, Needle):7	Push(Right, Needle):7	Push(Right, Needle):7	 ->Push(Right, Needle)
273 Push(Right, Needle):7	Push(Right, Needle):7	Push(Right, Needle):7	 ->Push(Right, Needle)
274 Push(Right, Needle):7	Push(Right, Needle):7	Push(Right, Needle):7	 ->Push(Right, Needle)
275 Push(Right, Needle):7	Push(Right, Needle):7	Push(Right, Needle):7	 ->Push(Right, Needle)
276 Push(Right, Needle):7	Push(Right, Needle):7	Push(Right, Needle):7	 ->Push(Right, Needle)
277 Push(Right, Needle):7	Push(Right, Needle):7	Push(Right, Needle):7	 ->Push(Right, Needle)
278 Push(Right, Needle):7	Push(Right, Needle):7	Push(Right, Needle):7	 ->Push(Right, Needle)
279 Push(Right, Needle):7	Push(Right, Needle):7	Push(Right, Needle):7	 ->Push(Right, Needle)
280 Push(Right, Needle):7	Push(Right, Needle):7	Push(Right, Needle):7	 ->Push(Right, Needle)
281 Push(Right, Needle):7	Push(Right, Needle):7	Push(Right, Needle):7	 ->Push(Right, Needle)
282 Push(Right, Needle):7	Push(Right, Needle):7	Push(Right, Needle):7	 ->Push(Right, Needle)
283 Push(Right, Needle):7	Push(Right, Needle):7	Push(Right, Needle):7	 ->Push(Right, Needle)
284 Push(Right, Needle):7	Push(Right, Needle):7	Push(Right, Needle):7	 ->Push(Right, Needle)
285 Push(Right, Needle):7	Push(Right, Needle):7	Push(Right, Needle):7	 ->Push(Right, Needle)
286 Push(Right, Needle):7	Push(Right, Needle):7	Push(Right, Needle):7	 ->Push(Right, Needle)
287 Push(Right, Needle):7	Push(Right, Needle):7	Push(Right, Needle):7	 ->Push(Right, Needle)
288 Push(Right, Needle):7	Push(Right, Needle):7	Push(Right, Needle):7	 ->Push(Right, Needle)
289 Push(Right, Needle):7	Push(Right, Needle):7	Push(Right, Needle):7	 ->Push(Right, Needle)
290 Push(Right, Needle):7	Push(Right, Needle):7	Push(Right, Needle):7	 ->Push(Right, Needle)
291 Push(Right, Needle):7	Push(Right, Needle):7	Push(Right, Needle):7	 ->Push(Right, Needle)
292 Push(Right, Needle):7	Push(Right, Needle):7	Push(Right, Needle):7	 ->Push(Right, Needle)
293 Push(Right, Needle):7	Push(Right, Needle):7	Push(Right, Needle):7	 ->Push(Right, Needle)
294 Push(Right, Needle):7	Push(Right, Needle):7	Push(Right, Needle):7	 ->Push(Right, Needle)
295 Push(Right, Needle):7	Push(Right, Needle):7	Push(Right, Needle):7	 ->Push(Right, Needle)
296 Push(Right, Needle):7	Push(Right, Needle):7	Push(Right, Needle):7	 ->Push(Right, Needle)
297 Push(Right, Needle):7	Push(Right, Needle):7	Push(Right, Needle):7	 ->Push(Right, Needle)
298 Push(Right, Needle):7	Push(Right, Needle):7	Push(Right, Needle):7	 ->Push(Right, Needle)
299 Push(Right, Needle):7	Push(Right, Needle):7	Push(Right, Needle):7	 ->Push(Right, Needle)
300 Push(Right, Needle):7	Push(Right, Needle):7	Push(Right, Needle):7	 ->Push(Right, Needle)
301 Push(Right, Needle):7	Push(Right, Needle):7	Push(Right, Needle):7	 ->Push(Right, Needle)
302 Push(Right, Needle):7	Push(Right, Needle):7	Push(Right, Needle):7	 ->Push(Right, Needle)
303 Push(Right, Needle):7	Push(Right, Needle):7	Push(Right, Needle):7	 ->Push(Right, Needle)
304 Push(Right, Needle):7	Push(Right, Needle):7	Push(Right, Needle):7	 ->Push(Right, Needle)
305 Push(Right, Needle):7	Push(Right, Needle):7	Push(Right, Needle):7	 ->Push(Right, Needle)
306 Push(Right, Needle):7	Push(Right, Needle):7	Push(Right, Needle):7	 ->Push(Right, Needle)
307 Push(Right, Needle):7	Push(Right, Needle):7	Push(Right, Needle):7	 ->Push(Right, Needle)
308 Push(Right, Needle):7	Push(Right, Needle):7	Push(Right, Needle):7	 ->Push(Right, Needle)
309 Push(Right, Needle):7	Push(Right, Needle):7	Push(Right, Needle):7	 ->Push(Right, Needle)
310 Push(Right, Needle):7	Push(Right, Needle):7	Push(Right, Needle):7	 ->Push(Right, Needle)
311 Push(Right, Needle):7	Push(Right, Needle):7	Push(Right, Needle):7	 ->Push(Right, Needle)
312 Push(Right, Needle):7	Push(Right, Needle):7	Push(Right, Needle):7	 ->Push(Right, Needle)
313 Push(Right, Needle):7	Push(Right, Needle):7	Push(Right, Needle):7	 ->Push(Right, Needle)
314 Push(Right, Needle):7	Push(Right, Needle):7	Push(Right, Needle):7	 ->Push(Right, Needle)
315 Push(Right, Needle):7	Push(Right, Needle):7	Push(Right, Needle):7	 ->Push(Right, Needle)
316 Push(Right, Needle):7	Push(Right, Needle):7	Push(Right, Needle):7	 ->Push(Right, Needle)
317 Push(Right, Needle):7	Push(Right, Needle):7	Push(Right, Needle):7	 ->Push(Right, Needle)
318 Push(Right, Needle):7	Push(Right, Needle):7	Push(Right, Needle):7	 ->Push(Right, Needle)
319 Push(Right, Needle):7	Push(Right, Needle):7	Push(Right, Needle):7	 ->Push(Right, Needle)
320 Push(Right, Needle):7	Push(Right, Needle):7	Push(Right, Needle):7	 ->Push(Right, Needle)
321 Push(Right, Needle):7	Push(Right, Needle):7	Push(Right, Needle):7	 ->Push(Right, Needle)
322 Push(Right, Needle):7	Push(Right, Needle):7	Push(Right, Needle):7	 ->Push(Right, Needle)
323 Push(Right, Needle):7	Push(Right, Needle):7	Push(Right, Needle):7	 ->Push(Right, Needle)
324 Push(Right, Needle):7	Push(Right, Needle):7	Push(Right, Needle):7	 ->Push(Right, Needle)
325 Push(Right, Needle):7	Push(Right, Needle):7	Push(Right, Needle):7	 ->Push(Right, Needle)
326 Push(Right, Needle):7	Push(Right, Needle):7	Push(Right, Needle):7	 ->Push(Right, Needle)
327 Push(Right, Needle):7	Push(Right, Needle):7	Push(Right, Needle):7	 ->Push(Right, Needle)
328 Push(Right, Needle):7	Push(Right, Needle):7	Push(Right, Needle):7	 ->Push(Right, Needle)
329 Push(Right, Needle):7	Push(Right, Needle):7	Push(Right, Needle):7	 ->Push(Right, Needle)
330 Push(Right, Needle):7	Push(Right, Needle):7	Push(Right, Needle):7	 ->Push(Right, Needle)
331 Push(Right, Needle):7	Push(Right, Needle):7	Push(Right, Needle):7	 ->Push(Right, Needle)
332 Push(Right, Needle):7	Push(Right, Needle):7	Push(Right, Needle):7	 ->Push(Right, Needle)
333 Push(Right, Needle):7	Push(Right, Needle):7	Push(Right, Needle):7	 ->Push(Right, Needle)
334 Push(Right, Needle):7	Push(Right, Needle):7	Push(Right, Needle):7	 ->Push(Right, Needle)
335 Push(Right, Needle):7	Push(Right, Needle):7	Push(Right, Needle):7	 ->Push(Right, Needle)
336 Push(Right, Needle):7	Push(Right, Needle):7	Push(Right, Needle):7	 ->Push(Right, Needle)
337 Push(Right, Needle):7	Push(Right, Needle):7	Push(Right, Needle):7	 ->Push(Right, Needle)
338 Push(Right, Needle):7	Push(Right, Needle):7	Push(Right, Needle):7	 ->Push(Right, Needle)
339 Push(Right, Needle):7	Push(Right, Needle):7	Push(Right, Needle):7	 ->Push(Right, Needle)
340 Push(Right, Needle):7	Push(Right, Needle):7	Push(Right, Needle):7	 ->Push(Right, Needle)
341 Push(Right, Needle):7	Push(Right, Needle):7	Push(Right, Needle):7	 ->Push(Right, Needle)
342 Push(Right, Needle):7	Push(Right, Needle):7	Push(Right, Needle):7	 ->Push(Right, Needle)
343 Push(Right, Needle):7	Push(Right, Needle):7	Push(Right, Needle):7	 ->Push(Right, Needle)
344 Push(Right, Needle):7	Push(Right, Needle):7	Push(Right, Needle):7	 ->Push(Right, Needle)
345 Push(Right, Needle):7	Push(Right, Needle):7	Push(Right, Needle):7	 ->Push(Right, Needle)
346 Push(Right, Needle):7	Push(Right, Needle):7	Push(Right, Needle):7	 ->Push(Right, Needle)
347 Push(Right, Needle):7	Push(Right, Needle):7	Push(Right, Needle):7	 ->Push(Right, Needle)
348 Push(Right, Needle):7	Push(Right, Needle):7	Push(Right, Needle):7	 ->Push(Right, Needle)
349 Push(Right, Needle):7	Push(Right, Needle):7	Push(Right, Needle):7	 ->Push(Right, Needle)
350 Push(Right, Needle):7	Push(Right, Needle):7	Touch(Left, Needle):9	 ->Push(Right, Needle)
351 Push(Right, Needle):7	Push(Right, Needle):7	Touch(Left, Needle):9	 ->Push(Right, Needle)
352 Push(Right, Needle):7	Push(Right, Needle):7	Touch(Left, Needle):9	 ->Push(Right, Needle)
353 Push(Right, Needle):7	Push(Right, Needle):7	Touch(Left, Needle):9	 ->Push(Right, Needle)
354 Push(Right, Needle):7	Push(Right, Needle):7	Touch(Left, Needle):9	 ->Push(Right, Needle)
355 Push(Right, Needle):7	Push(Right, Needle):7	Touch(Left, Needle):9	 ->Push(Right, Needle)
356 Push(Right, Needle):7	Push(Right, Needle):7	Touch(Left, Needle):9	 ->Push(Right, Needle)
357 Push(Right, Needle):7	Push(Right, Needle):7	Touch(Left, Needle):9	 ->Push(Right, Needle)
358 Push(Right, Needle):7	Push(Right, Needle):7	Touch(Left, Needle):9	 ->Push(Right, Needle)
359 Push(Right, Needle):7	Push(Right, Needle):7	Touch(Left, Needle):9	 ->Push(Right, Needle)
360 Push(Right, Needle):7	Push(Right, Needle):7	Touch(Left, Needle):9	 ->Push(Right, Needle)
361 Push(Right, Needle):7	Push(Right, Needle):7	Touch(Left, Needle):9	 ->Push(Right, Needle)
362 Push(Right, Needle):7	Push(Right, Needle):7	Touch(Left, Needle):9	 ->Push(Right, Needle)
363 Push(Right, Needle):7	Push(Right, Needle):7	Touch(Left, Needle):9	 ->Push(Right, Needle)
364 Push(Right, Needle):7	Push(Right, Needle):7	Touch(Left, Needle):9	 ->Push(Right, Needle)
365 Push(Right, Needle):7	Push(Right, Needle):7	Touch(Left, Needle):9	 ->Push(Right, Needle)
366 Grasp(Left, Needle):0	Push(Right, Needle):7	Touch(Left, Needle):9	 ->Grasp(Left, Needle)
367 Grasp(Left, Needle):0	Push(Right, Needle):7	Touch(Left, Needle):9	 ->Grasp(Left, Needle)
368 Grasp(Left, Needle):0	Push(Right, Needle):7	Touch(Left, Needle):9	 ->Grasp(Left, Needle)
369 Grasp(Left, Needle):0	Push(Right, Needle):7	Touch(Left, Needle):9	 ->Grasp(Left, Needle)
370 Grasp(Left, Needle):0	Push(Right, Needle):7	Touch(Left, Needle):9	 ->Grasp(Left, Needle)
371 Grasp(Left, Needle):0	Push(Right, Needle):7	Touch(Left, Needle):9	 ->Grasp(Left, Needle)
372 Grasp(Left, Needle):0	Push(Right, Needle):7	Touch(Left, Needle):9	 ->Grasp(Left, Needle)
373 Grasp(Left, Needle):0	Push(Right, Needle):7	Touch(Left, Needle):9	 ->Grasp(Left, Needle)
374 Grasp(Left, Needle):0	Push(Right, Needle):7	Touch(Left, Needle):9	 ->Grasp(Left, Needle)
375 Grasp(Left, Needle):0	Push(Right, Needle):7	Touch(Left, Needle):9	 ->Grasp(Left, Needle)
376 Grasp(Left, Needle):0	Push(Right, Needle):7	Touch(Left, Needle):9	 ->Grasp(Left, Needle)
377 Grasp(Left, Needle):0	Push(Right, Needle):7	Touch(Left, Needle):9	 ->Grasp(Left, Needle)
378 Grasp(Left, Needle):0	Push(Right, Needle):7	Touch(Left, Needle):9	 ->Grasp(Left, Needle)
379 Grasp(Left, Needle):0	Push(Right, Needle):7	Touch(Left, Needle):9	 ->Grasp(Left, Needle)
380 Grasp(Left, Needle):0	Push(Right, Needle):7	Touch(Left, Needle):9	 ->Grasp(Left, Needle)
381 Grasp(Left, Needle):0	Push(Right, Needle):7	Touch(Left, Needle):9	 ->Grasp(Left, Needle)
382 Grasp(Left, Needle):0	Push(Right, Needle):7	Touch(Left, Needle):9	 ->Grasp(Left, Needle)
383 Grasp(Left, Needle):0	Push(Right, Needle):7	Touch(Left, Needle):9	 ->Grasp(Left, Needle)
384 Grasp(Left, Needle):0	Push(Right, Needle):7	Grasp(Left, Needle):0	 ->Grasp(Left, Needle)
385 Grasp(Left, Needle):0	Push(Right, Needle):7	Grasp(Left, Needle):0	 ->Grasp(Left, Needle)
386 Grasp(Left, Needle):0	Push(Right, Needle):7	Grasp(Left, Needle):0	 ->Grasp(Left, Needle)
387 Grasp(Left, Needle):0	Push(Right, Needle):7	Grasp(Left, Needle):0	 ->Grasp(Left, Needle)
388 Grasp(Left, Needle):0	Push(Right, Needle):7	Grasp(Left, Needle):0	 ->Grasp(Left, Needle)
389 Grasp(Left, Needle):0	Push(Right, Needle):7	Grasp(Left, Needle):0	 ->Grasp(Left, Needle)
390 Grasp(Left, Needle):0	Push(Right, Needle):7	Grasp(Left, Needle):0	 ->Grasp(Left, Needle)
391 Grasp(Left, Needle):0	Push(Right, Needle):7	Grasp(Left, Needle):0	 ->Grasp(Left, Needle)
392 Grasp(Left, Needle):0	Push(Right, Needle):7	Grasp(Left, Needle):0	 ->Grasp(Left, Needle)
393 Grasp(Left, Needle):0	Push(Right, Needle):7	Grasp(Left, Needle):0	 ->Grasp(Left, Needle)
394 Grasp(Left, Needle):0	Push(Right, Needle):7	Grasp(Left, Needle):0	 ->Grasp(Left, Needle)
395 Grasp(Left, Needle):0	Push(Right, Needle):7	Grasp(Left, Needle):0	 ->Grasp(Left, Needle)
396 Grasp(Left, Needle):0	Push(Right, Needle):7	Grasp(Left, Needle):0	 ->Grasp(Left, Needle)
397 Grasp(Left, Needle):0	Push(Right, Needle):7	Grasp(Left, Needle):0	 ->Grasp(Left, Needle)
398 Grasp(Left, Needle):0	Push(Right, Needle):7	Grasp(Left, Needle):0	 ->Grasp(Left, Needle)
399 Grasp(Left, Needle):0	Push(Right, Needle):7	Grasp(Left, Needle):0	 ->Grasp(Left, Needle)
400 Grasp(Left, Needle):0	Push(Right, Needle):7	Grasp(Left, Needle):0	 ->Grasp(Left, Needle)
401 Grasp(Left, Needle):0	Push(Right, Needle):7	Grasp(Left, Needle):0	 ->Grasp(Left, Needle)
402 Grasp(Left, Needle):0	Push(Right, Needle):7	Grasp(Left, Needle):0	 ->Grasp(Left, Needle)
403 Grasp(Left, Needle):0	Push(Right, Needle):7	Grasp(Left, Needle):0	 ->Grasp(Left, Needle)
404 Grasp(Left, Needle):0	Push(Right, Needle):7	Grasp(Left, Needle):0	 ->Grasp(Left, Needle)
405 Grasp(Left, Needle):0	Push(Right, Needle):7	Release(Right, Needle):2	 ->Grasp(Left, Needle)
406 Grasp(Left, Needle):0	Grasp(Left, Needle):0	Release(Right, Needle):2	 ->Grasp(Left, Needle)
407 Grasp(Left, Needle):0	Grasp(Left, Needle):0	Release(Right, Needle):2	 ->Grasp(Left, Needle)
408 Grasp(Left, Needle):0	Grasp(Left, Needle):0	Release(Right, Needle):2	 ->Grasp(Left, Needle)
409 Grasp(Left, Needle):0	Grasp(Left, Needle):0	Release(Right, Needle):2	 ->Grasp(Left, Needle)
410 Grasp(Left, Needle):0	Grasp(Left, Needle):0	Release(Right, Needle):2	 ->Grasp(Left, Needle)
411 Grasp(Left, Needle):0	Grasp(Left, Needle):0	Release(Right, Needle):2	 ->Grasp(Left, Needle)
412 Grasp(Left, Needle):0	Grasp(Left, Needle):0	Release(Right, Needle):2	 ->Grasp(Left, Needle)
413 Grasp(Left, Needle):0	Grasp(Left, Needle):0	Release(Right, Needle):2	 ->Grasp(Left, Needle)
414 Grasp(Left, Needle):0	Grasp(Left, Needle):0	Untouch(Right, Needle):3	 ->Grasp(Left, Needle)
415 Grasp(Left, Needle):0	Grasp(Left, Needle):0	Untouch(Right, Needle):3	 ->Grasp(Left, Needle)
416 Grasp(Left, Needle):0	Grasp(Left, Needle):0	Untouch(Right, Needle):3	 ->Grasp(Left, Needle)
417 Grasp(Left, Needle):0	Grasp(Left, Needle):0	Untouch(Right, Needle):3	 ->Grasp(Left, Needle)
418 Grasp(Left, Needle):0	Release(Right, Needle):2	Untouch(Right, Needle):3	 ->Grasp(Left, Needle)
419 Grasp(Left, Needle):0	Release(Right, Needle):2	Untouch(Right, Needle):3	 ->Grasp(Left, Needle)
420 Grasp(Left, Needle):0	Pull(Left, Needle):10	Untouch(Right, Needle):3	 ->Grasp(Left, Needle)
421 Grasp(Left, Needle):0	Pull(Left, Needle):10	Pull(Left, Needle):10	 ->Pull(Left, Needle)
422 Pull(Left, Needle):10	Pull(Left, Needle):10	Pull(Left, Needle):10	 ->Pull(Left, Needle)
423 Pull(Left, Needle):10	Pull(Left, Needle):10	Pull(Left, Needle):10	 ->Pull(Left, Needle)
424 Pull(Left, Needle):10	Pull(Left, Needle):10	Pull(Left, Needle):10	 ->Pull(Left, Needle)
425 Pull(Left, Needle):10	Pull(Left, Needle):10	Pull(Left, Needle):10	 ->Pull(Left, Needle)
426 Pull(Left, Needle):10	Pull(Left, Needle):10	Pull(Left, Needle):10	 ->Pull(Left, Needle)
427 Pull(Left, Needle):10	Pull(Left, Needle):10	Pull(Left, Needle):10	 ->Pull(Left, Needle)
428 Pull(Left, Needle):10	Pull(Left, Needle):10	Pull(Left, Needle):10	 ->Pull(Left, Needle)
429 Pull(Left, Needle):10	Pull(Left, Needle):10	Pull(Left, Needle):10	 ->Pull(Left, Needle)
430 Pull(Left, Needle):10	Pull(Left, Needle):10	Pull(Left, Needle):10	 ->Pull(Left, Needle)
431 Pull(Left, Needle):10	Pull(Left, Needle):10	Pull(Left, Needle):10	 ->Pull(Left, Needle)
432 Pull(Left, Needle):10	Pull(Left, Needle):10	Pull(Left, Needle):10	 ->Pull(Left, Needle)
433 Pull(Left, Needle):10	Pull(Left, Needle):10	Pull(Left, Needle):10	 ->Pull(Left, Needle)
434 Pull(Left, Needle):10	Pull(Left, Needle):10	Pull(Left, Needle):10	 ->Pull(Left, Needle)
435 Pull(Left, Needle):10	Pull(Left, Needle):10	Pull(Left, Needle):10	 ->Pull(Left, Needle)
436 Pull(Left, Needle):10	Pull(Left, Needle):10	Pull(Left, Needle):10	 ->Pull(Left, Needle)
437 Pull(Left, Needle):10	Pull(Left, Needle):10	Pull(Left, Needle):10	 ->Pull(Left, Needle)
438 Pull(Left, Needle):10	Pull(Left, Needle):10	Pull(Left, Needle):10	 ->Pull(Left, Needle)
439 Pull(Left, Needle):10	Pull(Left, Needle):10	Pull(Left, Needle):10	 ->Pull(Left, Needle)
440 Pull(Left, Needle):10	Pull(Left, Needle):10	Pull(Left, Needle):10	 ->Pull(Left, Needle)
441 Pull(Left, Needle):10	Pull(Left, Needle):10	Pull(Left, Needle):10	 ->Pull(Left, Needle)
442 Pull(Left, Needle):10	Pull(Left, Needle):10	Pull(Left, Needle):10	 ->Pull(Left, Needle)
443 Pull(Left, Needle):10	Pull(Left, Needle):10	Pull(Left, Needle):10	 ->Pull(Left, Needle)
444 Pull(Left, Needle):10	Pull(Left, Needle):10	Pull(Left, Needle):10	 ->Pull(Left, Needle)
445 Pull(Left, Needle):10	Pull(Left, Needle):10	Pull(Left, Needle):10	 ->Pull(Left, Needle)
446 Pull(Left, Needle):10	Pull(Left, Needle):10	Pull(Left, Needle):10	 ->Pull(Left, Needle)
447 Pull(Left, Needle):10	Pull(Left, Needle):10	Pull(Left, Needle):10	 ->Pull(Left, Needle)
448 Pull(Left, Needle):10	Pull(Left, Needle):10	Pull(Left, Needle):10	 ->Pull(Left, Needle)
449 Pull(Left, Needle):10	Pull(Left, Needle):10	Pull(Left, Needle):10	 ->Pull(Left, Needle)
450 Pull(Left, Needle):10	Pull(Left, Needle):10	Pull(Left, Needle):10	 ->Pull(Left, Needle)
451 Pull(Left, Needle):10	Pull(Left, Needle):10	Pull(Left, Needle):10	 ->Pull(Left, Needle)
452 Pull(Left, Needle):10	Pull(Left, Needle):10	Pull(Left, Needle):10	 ->Pull(Left, Needle)
453 Pull(Left, Needle):10	Pull(Left, Needle):10	Pull(Left, Needle):10	 ->Pull(Left, Needle)
454 Pull(Left, Needle):10	Pull(Left, Needle):10	Pull(Left, Needle):10	 ->Pull(Left, Needle)
455 Pull(Left, Needle):10	Pull(Left, Needle):10	Pull(Left, Needle):10	 ->Pull(Left, Needle)
456 Pull(Left, Needle):10	Pull(Left, Needle):10	Pull(Left, Needle):10	 ->Pull(Left, Needle)
457 Pull(Left, Needle):10	Pull(Left, Needle):10	Pull(Left, Needle):10	 ->Pull(Left, Needle)
458 Pull(Left, Needle):10	Pull(Left, Needle):10	Pull(Left, Needle):10	 ->Pull(Left, Needle)
459 Pull(Left, Needle):10	Pull(Left, Needle):10	Pull(Left, Needle):10	 ->Pull(Left, Needle)
460 Pull(Left, Needle):10	Pull(Left, Needle):10	Pull(Left, Needle):10	 ->Pull(Left, Needle)
461 Pull(Left, Needle):10	Pull(Left, Needle):10	Pull(Left, Needle):10	 ->Pull(Left, Needle)
462 Pull(Left, Needle):10	Pull(Left, Needle):10	Pull(Left, Needle):10	 ->Pull(Left, Needle)
463 Pull(Left, Needle):10	Pull(Left, Needle):10	Pull(Left, Needle):10	 ->Pull(Left, Needle)
464 Pull(Left, Needle):10	Pull(Left, Needle):10	Pull(Left, Needle):10	 ->Pull(Left, Needle)
465 Pull(Left, Needle):10	Pull(Left, Needle):10	Pull(Left, Needle):10	 ->Pull(Left, Needle)
466 Pull(Left, Needle):10	Pull(Left, Needle):10	Pull(Left, Needle):10	 ->Pull(Left, Needle)
467 Pull(Left, Needle):10	Pull(Left, Needle):10	Pull(Left, Needle):10	 ->Pull(Left, Needle)
468 Pull(Left, Needle):10	Pull(Left, Needle):10	Pull(Left, Needle):10	 ->Pull(Left, Needle)
469 Pull(Left, Needle):10	Pull(Left, Needle):10	Pull(Left, Needle):10	 ->Pull(Left, Needle)
470 Pull(Left, Needle):10	Pull(Left, Needle):10	Pull(Left, Needle):10	 ->Pull(Left, Needle)
471 Pull(Left, Needle):10	Pull(Left, Needle):10	Pull(Left, Needle):10	 ->Pull(Left, Needle)
472 Pull(Left, Needle):10	Pull(Left, Needle):10	Pull(Left, Needle):10	 ->Pull(Left, Needle)
473 Pull(Left, Needle):10	Pull(Left, Needle):10	Pull(Left, Needle):10	 ->Pull(Left, Needle)
474 Pull(Left, Needle):10	Pull(Left, Needle):10	Pull(Left, Needle):10	 ->Pull(Left, Needle)
475 Pull(Left, Needle):10	Pull(Left, Needle):10	Pull(Left, Needle):10	 ->Pull(Left, Needle)
476 Pull(Left, Needle):10	Pull(Left, Needle):10	Pull(Left, Needle):10	 ->Pull(Left, Needle)
477 Pull(Left, Needle):10	Pull(Left, Needle):10	Pull(Left, Needle):10	 ->Pull(Left, Needle)
478 Pull(Left, Needle):10	Pull(Left, Needle):10	Pull(Left, Needle):10	 ->Pull(Left, Needle)
479 Pull(Left, Needle):10	Pull(Left, Needle):10	Pull(Left, Needle):10	 ->Pull(Left, Needle)
480 Pull(Left, Needle):10	Pull(Left, Needle):10	Pull(Left, Needle):10	 ->Pull(Left, Needle)
481 Pull(Left, Needle):10	Pull(Left, Needle):10	Pull(Left, Needle):10	 ->Pull(Left, Needle)
482 Pull(Left, Needle):10	Pull(Left, Needle):10	Pull(Left, Needle):10	 ->Pull(Left, Needle)
483 Pull(Left, Needle):10	Pull(Left, Needle):10	Pull(Left, Needle):10	 ->Pull(Left, Needle)
484 Pull(Left, Needle):10	Pull(Left, Needle):10	Pull(Left, Needle):10	 ->Pull(Left, Needle)
485 Pull(Left, Needle):10	Pull(Left, Needle):10	Pull(Left, Needle):10	 ->Pull(Left, Needle)
486 Pull(Left, Needle):10	Pull(Left, Needle):10	Pull(Left, Needle):10	 ->Pull(Left, Needle)
487 Pull(Left, Needle):10	Pull(Left, Needle):10	Pull(Left, Needle):10	 ->Pull(Left, Needle)
488 Pull(Left, Needle):10	Pull(Left, Needle):10	Pull(Left, Needle):10	 ->Pull(Left, Needle)
489 Pull(Left, Needle):10	Pull(Left, Needle):10	Pull(Left, Needle):10	 ->Pull(Left, Needle)
490 Pull(Left, Needle):10	Pull(Left, Needle):10	Pull(Left, Needle):10	 ->Pull(Left, Needle)
491 Pull(Left, Needle):10	Pull(Left, Needle):10	Pull(Left, Needle):10	 ->Pull(Left, Needle)
492 Pull(Left, Needle):10	Pull(Left, Needle):10	Pull(Left, Needle):10	 ->Pull(Left, Needle)
493 Pull(Left, Needle):10	Pull(Left, Needle):10	Pull(Left, Needle):10	 ->Pull(Left, Needle)
494 Pull(Left, Needle):10	Pull(Left, Needle):10	Pull(Left, Needle):10	 ->Pull(Left, Needle)
495 Pull(Left, Needle):10	Pull(Left, Needle):10	Pull(Left, Needle):10	 ->Pull(Left, Needle)
496 Pull(Left, Needle):10	Pull(Left, Needle):10	Pull(Left, Needle):10	 ->Pull(Left, Needle)
497 Pull(Left, Needle):10	Pull(Left, Needle):10	Pull(Left, Needle):10	 ->Pull(Left, Needle)
498 Pull(Left, Needle):10	Pull(Left, Needle):10	Touch(Right, Needle):4	 ->Pull(Left, Needle)
499 Pull(Left, Needle):10	Pull(Left, Needle):10	Touch(Right, Needle):4	 ->Pull(Left, Needle)
500 Pull(Left, Needle):10	Pull(Left, Needle):10	Touch(Right, Needle):4	 ->Pull(Left, Needle)
501 Pull(Left, Needle):10	Pull(Left, Needle):10	Touch(Right, Needle):4	 ->Pull(Left, Needle)
502 Pull(Left, Needle):10	Pull(Left, Needle):10	Touch(Right, Needle):4	 ->Pull(Left, Needle)
503 Pull(Left, Needle):10	Pull(Left, Needle):10	Touch(Right, Needle):4	 ->Pull(Left, Needle)
504 Pull(Left, Needle):10	Pull(Left, Needle):10	Touch(Right, Needle):4	 ->Pull(Left, Needle)
505 Pull(Left, Needle):10	Pull(Left, Needle):10	Touch(Right, Needle):4	 ->Pull(Left, Needle)
506 Pull(Left, Needle):10	Pull(Left, Needle):10	Touch(Right, Needle):4	 ->Pull(Left, Needle)
507 Pull(Left, Needle):10	Pull(Left, Needle):10	Touch(Right, Needle):4	 ->Pull(Left, Needle)
508 Pull(Left, Needle):10	Pull(Left, Needle):10	Touch(Right, Needle):4	 ->Pull(Left, Needle)
509 Pull(Left, Needle):10	Pull(Left, Needle):10	Touch(Right, Needle):4	 ->Pull(Left, Needle)
510 Pull(Left, Needle):10	Pull(Left, Needle):10	Touch(Right, Needle):4	 ->Pull(Left, Needle)
511 Pull(Left, Needle):10	Pull(Left, Needle):10	Touch(Right, Needle):4	 ->Pull(Left, Needle)
512 Pull(Left, Needle):10	Pull(Left, Needle):10	Touch(Right, Needle):4	 ->Pull(Left, Needle)
513 Pull(Left, Needle):10	Pull(Left, Needle):10	Touch(Right, Needle):4	 ->Pull(Left, Needle)
514 Pull(Left, Needle):10	Pull(Left, Needle):10	Touch(Right, Needle):4	 ->Pull(Left, Needle)
515 Pull(Left, Needle):10	Pull(Left, Needle):10	Touch(Right, Needle):4	 ->Pull(Left, Needle)
516 Pull(Left, Needle):10	Pull(Left, Needle):10	Touch(Right, Needle):4	 ->Pull(Left, Needle)
517 Pull(Left, Needle):10	Pull(Left, Needle):10	Touch(Right, Needle):4	 ->Pull(Left, Needle)
518 Pull(Left, Needle):10	Pull(Left, Needle):10	Touch(Right, Needle):4	 ->Pull(Left, Needle)
519 Pull(Left, Needle):10	Pull(Left, Needle):10	Touch(Right, Needle):4	 ->Pull(Left, Needle)
520 Pull(Left, Needle):10	Pull(Left, Needle):10	Touch(Right, Needle):4	 ->Pull(Left, Needle)
521 Pull(Left, Needle):10	Pull(Left, Needle):10	Touch(Right, Needle):4	 ->Pull(Left, Needle)
522 Pull(Left, Needle):10	Pull(Left, Needle):10	Touch(Right, Needle):4	 ->Pull(Left, Needle)
523 Pull(Left, Needle):10	Pull(Left, Needle):10	Touch(Right, Needle):4	 ->Pull(Left, Needle)
524 Pull(Left, Needle):10	Pull(Left, Needle):10	Touch(Right, Needle):4	 ->Pull(Left, Needle)
525 Pull(Left, Needle):10	Pull(Left, Needle):10	Touch(Right, Needle):4	 ->Pull(Left, Needle)
526 Pull(Left, Needle):10	Pull(Left, Needle):10	Touch(Right, Needle):4	 ->Pull(Left, Needle)
527 Pull(Left, Needle):10	Pull(Left, Needle):10	Touch(Right, Needle):4	 ->Pull(Left, Needle)
528 Pull(Left, Needle):10	Pull(Left, Needle):10	Touch(Right, Needle):4	 ->Pull(Left, Needle)
529 Pull(Left, Needle):10	Pull(Left, Needle):10	Touch(Right, Needle):4	 ->Pull(Left, Needle)
530 Grasp(Right, Needle):1	Pull(Left, Needle):10	Touch(Right, Needle):4	 ->Grasp(Right, Needle)
531 Grasp(Right, Needle):1	Pull(Left, Needle):10	Touch(Right, Needle):4	 ->Grasp(Right, Needle)
532 Grasp(Right, Needle):1	Pull(Left, Needle):10	Touch(Right, Needle):4	 ->Grasp(Right, Needle)
533 Grasp(Right, Needle):1	Pull(Left, Needle):10	Touch(Right, Needle):4	 ->Grasp(Right, Needle)
534 Grasp(Right, Needle):1	Pull(Left, Needle):10	Touch(Right, Needle):4	 ->Grasp(Right, Needle)
535 Grasp(Right, Needle):1	Pull(Left, Needle):10	Touch(Right, Needle):4	 ->Grasp(Right, Needle)
536 Grasp(Right, Needle):1	Pull(Left, Needle):10	Touch(Right, Needle):4	 ->Grasp(Right, Needle)
537 Grasp(Right, Needle):1	Pull(Left, Needle):10	Touch(Right, Needle):4	 ->Grasp(Right, Needle)
538 Grasp(Right, Needle):1	Pull(Left, Needle):10	Touch(Right, Needle):4	 ->Grasp(Right, Needle)
539 Grasp(Right, Needle):1	Pull(Left, Needle):10	Touch(Right, Needle):4	 ->Grasp(Right, Needle)
540 Grasp(Right, Needle):1	Pull(Left, Needle):10	Touch(Right, Needle):4	 ->Grasp(Right, Needle)
541 Grasp(Right, Needle):1	Pull(Left, Needle):10	Touch(Right, Needle):4	 ->Grasp(Right, Needle)
542 Grasp(Right, Needle):1	Pull(Left, Needle):10	Touch(Right, Needle):4	 ->Grasp(Right, Needle)
543 Grasp(Right, Needle):1	Pull(Left, Needle):10	Touch(Right, Needle):4	 ->Grasp(Right, Needle)
544 Grasp(Right, Needle):1	Pull(Left, Needle):10	Touch(Right, Needle):4	 ->Grasp(Right, Needle)
545 Grasp(Right, Needle):1	Pull(Left, Needle):10	Touch(Right, Needle):4	 ->Grasp(Right, Needle)
546 Grasp(Right, Needle):1	Pull(Left, Needle):10	Touch(Right, Needle):4	 ->Grasp(Right, Needle)
547 Grasp(Right, Needle):1	Pull(Left, Needle):10	Touch(Right, Needle):4	 ->Grasp(Right, Needle)
548 Grasp(Right, Needle):1	Pull(Left, Needle):10	Touch(Right, Needle):4	 ->Grasp(Right, Needle)
549 Grasp(Right, Needle):1	Pull(Left, Needle):10	Touch(Right, Needle):4	 ->Grasp(Right, Needle)
550 Grasp(Right, Needle):1	Pull(Left, Needle):10	Touch(Right, Needle):4	 ->Grasp(Right, Needle)
551 Grasp(Right, Needle):1	Pull(Left, Needle):10	Touch(Right, Needle):4	 ->Grasp(Right, Needle)
552 Grasp(Right, Needle):1	Pull(Left, Needle):10	Touch(Right, Needle):4	 ->Grasp(Right, Needle)
553 Grasp(Right, Needle):1	Pull(Left, Needle):10	Touch(Right, Needle):4	 ->Grasp(Right, Needle)
554 Grasp(Right, Needle):1	Pull(Left, Needle):10	Touch(Right, Needle):4	 ->Grasp(Right, Needle)
555 Grasp(Right, Needle):1	Pull(Left, Needle):10	Touch(Right, Needle):4	 ->Grasp(Right, Needle)
556 Grasp(Right, Needle):1	Pull(Left, Needle):10	Touch(Right, Needle):4	 ->Grasp(Right, Needle)
557 Grasp(Right, Needle):1	Pull(Left, Needle):10	Touch(Right, Needle):4	 ->Grasp(Right, Needle)
558 Grasp(Right, Needle):1	Pull(Left, Needle):10	Touch(Right, Needle):4	 ->Grasp(Right, Needle)
559 Grasp(Right, Needle):1	Pull(Left, Needle):10	Touch(Right, Needle):4	 ->Grasp(Right, Needle)
560 Grasp(Right, Needle):1	Pull(Left, Needle):10	Touch(Right, Needle):4	 ->Grasp(Right, Needle)
561 Grasp(Right, Needle):1	Pull(Left, Needle):10	Touch(Right, Needle):4	 ->Grasp(Right, Needle)
562 Grasp(Right, Needle):1	Pull(Left, Needle):10	Touch(Right, Needle):4	 ->Grasp(Right, Needle)
563 Grasp(Right, Needle):1	Pull(Left, Needle):10	Touch(Right, Needle):4	 ->Grasp(Right, Needle)
564 Grasp(Right, Needle):1	Pull(Left, Needle):10	Touch(Right, Needle):4	 ->Grasp(Right, Needle)
565 Grasp(Right, Needle):1	Pull(Left, Needle):10	Touch(Right, Needle):4	 ->Grasp(Right, Needle)
566 Grasp(Right, Needle):1	Pull(Left, Needle):10	Touch(Right, Needle):4	 ->Grasp(Right, Needle)
567 Grasp(Right, Needle):1	Pull(Left, Needle):10	Touch(Right, Needle):4	 ->Grasp(Right, Needle)
568 Grasp(Right, Needle):1	Pull(Left, Needle):10	Touch(Right, Needle):4	 ->Grasp(Right, Needle)
569 Grasp(Right, Needle):1	Pull(Left, Needle):10	Touch(Right, Needle):4	 ->Grasp(Right, Needle)
570 Grasp(Right, Needle):1	Pull(Left, Needle):10	Touch(Right, Needle):4	 ->Grasp(Right, Needle)
571 Grasp(Right, Needle):1	Pull(Left, Needle):10	Grasp(Right, Needle):1	 ->Grasp(Right, Needle)
572 Grasp(Right, Needle):1	Pull(Left, Needle):10	Grasp(Right, Needle):1	 ->Grasp(Right, Needle)
573 Grasp(Right, Needle):1	Pull(Left, Needle):10	Grasp(Right, Needle):1	 ->Grasp(Right, Needle)
574 Grasp(Right, Needle):1	Pull(Left, Needle):10	Grasp(Right, Needle):1	 ->Grasp(Right, Needle)
575 Grasp(Right, Needle):1	Pull(Left, Needle):10	Grasp(Right, Needle):1	 ->Grasp(Right, Needle)
576 Grasp(Right, Needle):1	Pull(Left, Needle):10	Grasp(Right, Needle):1	 ->Grasp(Right, Needle)
577 Grasp(Right, Needle):1	Pull(Left, Needle):10	Grasp(Right, Needle):1	 ->Grasp(Right, Needle)
578 Grasp(Right, Needle):1	Grasp(Right, Needle):1	Grasp(Right, Needle):1	 ->Grasp(Right, Needle)
579 Grasp(Right, Needle):1	Grasp(Right, Needle):1	Grasp(Right, Needle):1	 ->Grasp(Right, Needle)
580 Grasp(Right, Needle):1	Grasp(Right, Needle):1	Grasp(Right, Needle):1	 ->Grasp(Right, Needle)
581 Grasp(Right, Needle):1	Grasp(Right, Needle):1	Grasp(Right, Needle):1	 ->Grasp(Right, Needle)
582 Grasp(Right, Needle):1	Grasp(Right, Needle):1	Grasp(Right, Needle):1	 ->Grasp(Right, Needle)
583 Grasp(Right, Needle):1	Grasp(Right, Needle):1	Release(Left, Needle):5	 ->Grasp(Right, Needle)
584 Grasp(Right, Needle):1	Grasp(Right, Needle):1	Release(Left, Needle):5	 ->Grasp(Right, Needle)
585 Grasp(Right, Needle):1	Grasp(Right, Needle):1	Release(Left, Needle):5	 ->Grasp(Right, Needle)
586 Grasp(Right, Needle):1	Grasp(Right, Needle):1	Release(Left, Needle):5	 ->Grasp(Right, Needle)
587 Grasp(Right, Needle):1	Release(Left, Needle):5	Untouch(Left, Needle):6	 ->Grasp(Right, Needle)
588 Grasp(Right, Needle):1	Release(Left, Needle):5	Untouch(Left, Needle):6	 ->Grasp(Right, Needle)
589 Grasp(Right, Needle):1	Release(Left, Needle):5	Untouch(Left, Needle):6	 ->Grasp(Right, Needle)
590 Grasp(Right, Needle):1	Release(Left, Needle):5	Untouch(Left, Needle):6	 ->Grasp(Right, Needle)
591 Grasp(Right, Needle):1	Release(Left, Needle):5	Untouch(Left, Needle):6	 ->Grasp(Right, Needle)
592 Grasp(Right, Needle):1	Release(Left, Needle):5	Untouch(Left, Needle):6	 ->Grasp(Right, Needle)
593 Grasp(Right, Needle):1	Release(Left, Needle):5	Untouch(Left, Needle):6	 ->Grasp(Right, Needle)
594 Grasp(Right, Needle):1	Release(Left, Needle):5	Untouch(Left, Needle):6	 ->Grasp(Right, Needle)
595 Grasp(Right, Needle):1	Release(Left, Needle):5	Push(Right, Needle):7	 ->Grasp(Right, Needle)
596 Grasp(Right, Needle):1	Release(Left, Needle):5	Push(Right, Needle):7	 ->Grasp(Right, Needle)
597 Grasp(Right, Needle):1	Release(Left, Needle):5	Push(Right, Needle):7	 ->Grasp(Right, Needle)
598 Grasp(Right, Needle):1	Release(Left, Needle):5	Push(Right, Needle):7	 ->Grasp(Right, Needle)
599 Grasp(Right, Needle):1	Release(Left, Needle):5	Push(Right, Needle):7	 ->Grasp(Right, Needle)
600 Grasp(Right, Needle):1	Release(Left, Needle):5	Push(Right, Needle):7	 ->Grasp(Right, Needle)
601 Grasp(Right, Needle):1	Release(Left, Needle):5	Push(Right, Needle):7	 ->Grasp(Right, Needle)
602 Grasp(Right, Needle):1	Release(Left, Needle):5	Push(Right, Needle):7	 ->Grasp(Right, Needle)
603 Grasp(Right, Needle):1	Release(Left, Needle):5	Push(Right, Needle):7	 ->Grasp(Right, Needle)
604 Grasp(Right, Needle):1	Release(Left, Needle):5	Push(Right, Needle):7	 ->Grasp(Right, Needle)
605 Grasp(Right, Needle):1	Release(Left, Needle):5	Push(Right, Needle):7	 ->Grasp(Right, Needle)
606 Grasp(Right, Needle):1	Release(Left, Needle):5	Push(Right, Needle):7	 ->Grasp(Right, Needle)
607 Grasp(Right, Needle):1	Release(Left, Needle):5	Push(Right, Needle):7	 ->Grasp(Right, Needle)
608 Grasp(Right, Needle):1	Release(Left, Needle):5	Push(Right, Needle):7	 ->Grasp(Right, Needle)
609 Grasp(Right, Needle):1	Release(Left, Needle):5	Push(Right, Needle):7	 ->Grasp(Right, Needle)
610 Grasp(Right, Needle):1	Release(Left, Needle):5	Push(Right, Needle):7	 ->Grasp(Right, Needle)
611 Grasp(Right, Needle):1	Release(Left, Needle):5	Push(Right, Needle):7	 ->Grasp(Right, Needle)
612 Grasp(Right, Needle):1	Release(Left, Needle):5	Push(Right, Needle):7	 ->Grasp(Right, Needle)
613 Grasp(Right, Needle):1	Release(Left, Needle):5	Push(Right, Needle):7	 ->Grasp(Right, Needle)
614 Push(Right, Needle):7	Release(Left, Needle):5	Push(Right, Needle):7	 ->Push(Right, Needle)
615 Push(Right, Needle):7	Release(Left, Needle):5	Push(Right, Needle):7	 ->Push(Right, Needle)
616 Push(Right, Needle):7	Release(Left, Needle):5	Push(Right, Needle):7	 ->Push(Right, Needle)
617 Push(Right, Needle):7	Release(Left, Needle):5	Push(Right, Needle):7	 ->Push(Right, Needle)
618 Push(Right, Needle):7	Release(Left, Needle):5	Push(Right, Needle):7	 ->Push(Right, Needle)
619 Push(Right, Needle):7	Release(Left, Needle):5	Push(Right, Needle):7	 ->Push(Right, Needle)
620 Push(Right, Needle):7	Release(Left, Needle):5	Push(Right, Needle):7	 ->Push(Right, Needle)
621 Push(Right, Needle):7	Release(Left, Needle):5	Push(Right, Needle):7	 ->Push(Right, Needle)
622 Push(Right, Needle):7	Release(Left, Needle):5	Push(Right, Needle):7	 ->Push(Right, Needle)
623 Push(Right, Needle):7	Release(Left, Needle):5	Push(Right, Needle):7	 ->Push(Right, Needle)
624 Push(Right, Needle):7	Release(Left, Needle):5	Push(Right, Needle):7	 ->Push(Right, Needle)
625 Push(Right, Needle):7	Release(Left, Needle):5	Push(Right, Needle):7	 ->Push(Right, Needle)
626 Push(Right, Needle):7	Release(Left, Needle):5	Push(Right, Needle):7	 ->Push(Right, Needle)
627 Push(Right, Needle):7	Release(Left, Needle):5	Push(Right, Needle):7	 ->Push(Right, Needle)
628 Push(Right, Needle):7	Release(Left, Needle):5	Push(Right, Needle):7	 ->Push(Right, Needle)
629 Push(Right, Needle):7	Release(Left, Needle):5	Push(Right, Needle):7	 ->Push(Right, Needle)
630 Push(Right, Needle):7	Release(Left, Needle):5	Push(Right, Needle):7	 ->Push(Right, Needle)
631 Push(Right, Needle):7	Release(Left, Needle):5	Push(Right, Needle):7	 ->Push(Right, Needle)
632 Push(Right, Needle):7	Release(Left, Needle):5	Push(Right, Needle):7	 ->Push(Right, Needle)
633 Push(Right, Needle):7	Release(Left, Needle):5	Push(Right, Needle):7	 ->Push(Right, Needle)
634 Push(Right, Needle):7	Release(Left, Needle):5	Push(Right, Needle):7	 ->Push(Right, Needle)
635 Push(Right, Needle):7	Release(Left, Needle):5	Push(Right, Needle):7	 ->Push(Right, Needle)
636 Push(Right, Needle):7	Release(Left, Needle):5	Push(Right, Needle):7	 ->Push(Right, Needle)
637 Push(Right, Needle):7	Release(Left, Needle):5	Push(Right, Needle):7	 ->Push(Right, Needle)
638 Push(Right, Needle):7	Release(Left, Needle):5	Push(Right, Needle):7	 ->Push(Right, Needle)
639 Push(Right, Needle):7	Release(Left, Needle):5	Push(Right, Needle):7	 ->Push(Right, Needle)
640 Push(Right, Needle):7	Release(Left, Needle):5	Push(Right, Needle):7	 ->Push(Right, Needle)
641 Push(Right, Needle):7	Release(Left, Needle):5	Push(Right, Needle):7	 ->Push(Right, Needle)
642 Push(Right, Needle):7	Release(Left, Needle):5	Push(Right, Needle):7	 ->Push(Right, Needle)
643 Push(Right, Needle):7	Release(Left, Needle):5	Push(Right, Needle):7	 ->Push(Right, Needle)
644 Push(Right, Needle):7	Release(Left, Needle):5	Push(Right, Needle):7	 ->Push(Right, Needle)
645 Push(Right, Needle):7	Release(Left, Needle):5	Push(Right, Needle):7	 ->Push(Right, Needle)
646 Push(Right, Needle):7	Release(Left, Needle):5	Push(Right, Needle):7	 ->Push(Right, Needle)
647 Push(Right, Needle):7	Release(Left, Needle):5	Push(Right, Needle):7	 ->Push(Right, Needle)
648 Push(Right, Needle):7	Release(Left, Needle):5	Push(Right, Needle):7	 ->Push(Right, Needle)
649 Push(Right, Needle):7	Release(Left, Needle):5	Push(Right, Needle):7	 ->Push(Right, Needle)
650 Push(Right, Needle):7	Release(Left, Needle):5	Push(Right, Needle):7	 ->Push(Right, Needle)
651 Push(Right, Needle):7	Release(Left, Needle):5	Push(Right, Needle):7	 ->Push(Right, Needle)
652 Push(Right, Needle):7	Release(Left, Needle):5	Push(Right, Needle):7	 ->Push(Right, Needle)
653 Push(Right, Needle):7	Release(Left, Needle):5	Push(Right, Needle):7	 ->Push(Right, Needle)
654 Push(Right, Needle):7	Release(Left, Needle):5	Push(Right, Needle):7	 ->Push(Right, Needle)
655 Push(Right, Needle):7	Release(Left, Needle):5	Push(Right, Needle):7	 ->Push(Right, Needle)
656 Push(Right, Needle):7	Release(Left, Needle):5	Push(Right, Needle):7	 ->Push(Right, Needle)
657 Push(Right, Needle):7	Release(Left, Needle):5	Push(Right, Needle):7	 ->Push(Right, Needle)
658 Push(Right, Needle):7	Release(Left, Needle):5	Push(Right, Needle):7	 ->Push(Right, Needle)
659 Push(Right, Needle):7	Release(Left, Needle):5	Push(Right, Needle):7	 ->Push(Right, Needle)
660 Push(Right, Needle):7	Release(Left, Needle):5	Push(Right, Needle):7	 ->Push(Right, Needle)
661 Push(Right, Needle):7	Release(Left, Needle):5	Push(Right, Needle):7	 ->Push(Right, Needle)
662 Push(Right, Needle):7	Release(Left, Needle):5	Push(Right, Needle):7	 ->Push(Right, Needle)
663 Push(Right, Needle):7	Release(Left, Needle):5	Push(Right, Needle):7	 ->Push(Right, Needle)
664 Push(Right, Needle):7	Release(Left, Needle):5	Push(Right, Needle):7	 ->Push(Right, Needle)
665 Push(Right, Needle):7	Release(Left, Needle):5	Push(Right, Needle):7	 ->Push(Right, Needle)
666 Push(Right, Needle):7	Touch(Needle, Fabric/Tissue):8	Push(Right, Needle):7	 ->Push(Right, Needle)
667 Push(Right, Needle):7	Touch(Needle, Fabric/Tissue):8	Push(Right, Needle):7	 ->Push(Right, Needle)
668 Push(Right, Needle):7	Touch(Needle, Fabric/Tissue):8	Push(Right, Needle):7	 ->Push(Right, Needle)
669 Push(Right, Needle):7	Touch(Needle, Fabric/Tissue):8	Push(Right, Needle):7	 ->Push(Right, Needle)
670 Push(Right, Needle):7	Touch(Needle, Fabric/Tissue):8	Push(Right, Needle):7	 ->Push(Right, Needle)
671 Push(Right, Needle):7	Touch(Needle, Fabric/Tissue):8	Push(Right, Needle):7	 ->Push(Right, Needle)
672 Push(Right, Needle):7	Touch(Needle, Fabric/Tissue):8	Push(Right, Needle):7	 ->Push(Right, Needle)
673 Push(Right, Needle):7	Touch(Needle, Fabric/Tissue):8	Push(Right, Needle):7	 ->Push(Right, Needle)
674 Push(Right, Needle):7	Touch(Needle, Fabric/Tissue):8	Push(Right, Needle):7	 ->Push(Right, Needle)
675 Push(Right, Needle):7	Touch(Needle, Fabric/Tissue):8	Push(Right, Needle):7	 ->Push(Right, Needle)
676 Push(Right, Needle):7	Touch(Needle, Fabric/Tissue):8	Push(Right, Needle):7	 ->Push(Right, Needle)
677 Push(Right, Needle):7	Touch(Needle, Fabric/Tissue):8	Push(Right, Needle):7	 ->Push(Right, Needle)
678 Push(Right, Needle):7	Touch(Needle, Fabric/Tissue):8	Push(Right, Needle):7	 ->Push(Right, Needle)
679 Push(Right, Needle):7	Touch(Needle, Fabric/Tissue):8	Push(Right, Needle):7	 ->Push(Right, Needle)
680 Push(Right, Needle):7	Touch(Needle, Fabric/Tissue):8	Push(Right, Needle):7	 ->Push(Right, Needle)
681 Push(Right, Needle):7	Touch(Needle, Fabric/Tissue):8	Push(Right, Needle):7	 ->Push(Right, Needle)
682 Push(Right, Needle):7	Touch(Needle, Fabric/Tissue):8	Push(Right, Needle):7	 ->Push(Right, Needle)
683 Push(Right, Needle):7	Touch(Needle, Fabric/Tissue):8	Push(Right, Needle):7	 ->Push(Right, Needle)
684 Push(Right, Needle):7	Touch(Needle, Fabric/Tissue):8	Push(Right, Needle):7	 ->Push(Right, Needle)
685 Push(Right, Needle):7	Touch(Needle, Fabric/Tissue):8	Push(Right, Needle):7	 ->Push(Right, Needle)
686 Push(Right, Needle):7	Touch(Needle, Fabric/Tissue):8	Push(Right, Needle):7	 ->Push(Right, Needle)
687 Push(Right, Needle):7	Touch(Needle, Fabric/Tissue):8	Push(Right, Needle):7	 ->Push(Right, Needle)
688 Push(Right, Needle):7	Touch(Needle, Fabric/Tissue):8	Push(Right, Needle):7	 ->Push(Right, Needle)
689 Push(Right, Needle):7	Touch(Needle, Fabric/Tissue):8	Push(Right, Needle):7	 ->Push(Right, Needle)
690 Push(Right, Needle):7	Touch(Needle, Fabric/Tissue):8	Push(Right, Needle):7	 ->Push(Right, Needle)
691 Push(Right, Needle):7	Touch(Needle, Fabric/Tissue):8	Push(Right, Needle):7	 ->Push(Right, Needle)
692 Push(Right, Needle):7	Touch(Needle, Fabric/Tissue):8	Push(Right, Needle):7	 ->Push(Right, Needle)
693 Push(Right, Needle):7	Touch(Needle, Fabric/Tissue):8	Push(Right, Needle):7	 ->Push(Right, Needle)
694 Push(Right, Needle):7	Touch(Needle, Fabric/Tissue):8	Push(Right, Needle):7	 ->Push(Right, Needle)
695 Push(Right, Needle):7	Touch(Needle, Fabric/Tissue):8	Push(Right, Needle):7	 ->Push(Right, Needle)
696 Push(Right, Needle):7	Touch(Needle, Fabric/Tissue):8	Push(Right, Needle):7	 ->Push(Right, Needle)
697 Push(Right, Needle):7	Touch(Needle, Fabric/Tissue):8	Push(Right, Needle):7	 ->Push(Right, Needle)
698 Push(Right, Needle):7	Touch(Needle, Fabric/Tissue):8	Push(Right, Needle):7	 ->Push(Right, Needle)
699 Push(Right, Needle):7	Touch(Needle, Fabric/Tissue):8	Push(Right, Needle):7	 ->Push(Right, Needle)
700 Push(Right, Needle):7	Touch(Needle, Fabric/Tissue):8	Push(Right, Needle):7	 ->Push(Right, Needle)
701 Push(Right, Needle):7	Touch(Needle, Fabric/Tissue):8	Push(Right, Needle):7	 ->Push(Right, Needle)
702 Push(Right, Needle):7	Touch(Needle, Fabric/Tissue):8	Push(Right, Needle):7	 ->Push(Right, Needle)
703 Push(Right, Needle):7	Push(Right, Needle):7	Push(Right, Needle):7	 ->Push(Right, Needle)
704 Push(Right, Needle):7	Push(Right, Needle):7	Push(Right, Needle):7	 ->Push(Right, Needle)
705 Push(Right, Needle):7	Push(Right, Needle):7	Push(Right, Needle):7	 ->Push(Right, Needle)
706 Push(Right, Needle):7	Push(Right, Needle):7	Push(Right, Needle):7	 ->Push(Right, Needle)
707 Push(Right, Needle):7	Push(Right, Needle):7	Push(Right, Needle):7	 ->Push(Right, Needle)
708 Push(Right, Needle):7	Push(Right, Needle):7	Push(Right, Needle):7	 ->Push(Right, Needle)
709 Push(Right, Needle):7	Push(Right, Needle):7	Push(Right, Needle):7	 ->Push(Right, Needle)
710 Push(Right, Needle):7	Push(Right, Needle):7	Push(Right, Needle):7	 ->Push(Right, Needle)
711 Push(Right, Needle):7	Push(Right, Needle):7	Push(Right, Needle):7	 ->Push(Right, Needle)
712 Push(Right, Needle):7	Push(Right, Needle):7	Push(Right, Needle):7	 ->Push(Right, Needle)
713 Push(Right, Needle):7	Push(Right, Needle):7	Push(Right, Needle):7	 ->Push(Right, Needle)
714 Push(Right, Needle):7	Push(Right, Needle):7	Push(Right, Needle):7	 ->Push(Right, Needle)
715 Push(Right, Needle):7	Push(Right, Needle):7	Push(Right, Needle):7	 ->Push(Right, Needle)
716 Push(Right, Needle):7	Push(Right, Needle):7	Push(Right, Needle):7	 ->Push(Right, Needle)
717 Push(Right, Needle):7	Push(Right, Needle):7	Push(Right, Needle):7	 ->Push(Right, Needle)
718 Push(Right, Needle):7	Push(Right, Needle):7	Push(Right, Needle):7	 ->Push(Right, Needle)
719 Push(Right, Needle):7	Push(Right, Needle):7	Push(Right, Needle):7	 ->Push(Right, Needle)
720 Push(Right, Needle):7	Push(Right, Needle):7	Push(Right, Needle):7	 ->Push(Right, Needle)
721 Push(Right, Needle):7	Push(Right, Needle):7	Push(Right, Needle):7	 ->Push(Right, Needle)
722 Push(Right, Needle):7	Push(Right, Needle):7	Push(Right, Needle):7	 ->Push(Right, Needle)
723 Push(Right, Needle):7	Push(Right, Needle):7	Push(Right, Needle):7	 ->Push(Right, Needle)
724 Push(Right, Needle):7	Push(Right, Needle):7	Push(Right, Needle):7	 ->Push(Right, Needle)
725 Push(Right, Needle):7	Push(Right, Needle):7	Push(Right, Needle):7	 ->Push(Right, Needle)
726 Push(Right, Needle):7	Push(Right, Needle):7	Push(Right, Needle):7	 ->Push(Right, Needle)
727 Push(Right, Needle):7	Push(Right, Needle):7	Push(Right, Needle):7	 ->Push(Right, Needle)
728 Push(Right, Needle):7	Push(Right, Needle):7	Push(Right, Needle):7	 ->Push(Right, Needle)
729 Push(Right, Needle):7	Push(Right, Needle):7	Push(Right, Needle):7	 ->Push(Right, Needle)
730 Push(Right, Needle):7	Push(Right, Needle):7	Push(Right, Needle):7	 ->Push(Right, Needle)
731 Push(Right, Needle):7	Push(Right, Needle):7	Push(Right, Needle):7	 ->Push(Right, Needle)
732 Push(Right, Needle):7	Push(Right, Needle):7	Push(Right, Needle):7	 ->Push(Right, Needle)
733 Push(Right, Needle):7	Push(Right, Needle):7	Push(Right, Needle):7	 ->Push(Right, Needle)
734 Push(Right, Needle):7	Push(Right, Needle):7	Push(Right, Needle):7	 ->Push(Right, Needle)
735 Push(Right, Needle):7	Push(Right, Needle):7	Push(Right, Needle):7	 ->Push(Right, Needle)
736 Push(Right, Needle):7	Push(Right, Needle):7	Push(Right, Needle):7	 ->Push(Right, Needle)
737 Push(Right, Needle):7	Push(Right, Needle):7	Push(Right, Needle):7	 ->Push(Right, Needle)
738 Push(Right, Needle):7	Push(Right, Needle):7	Push(Right, Needle):7	 ->Push(Right, Needle)
739 Push(Right, Needle):7	Push(Right, Needle):7	Push(Right, Needle):7	 ->Push(Right, Needle)
740 Push(Right, Needle):7	Push(Right, Needle):7	Push(Right, Needle):7	 ->Push(Right, Needle)
741 Push(Right, Needle):7	Push(Right, Needle):7	Push(Right, Needle):7	 ->Push(Right, Needle)
742 Push(Right, Needle):7	Push(Right, Needle):7	Push(Right, Needle):7	 ->Push(Right, Needle)
743 Push(Right, Needle):7	Push(Right, Needle):7	Push(Right, Needle):7	 ->Push(Right, Needle)
744 Push(Right, Needle):7	Push(Right, Needle):7	Push(Right, Needle):7	 ->Push(Right, Needle)
745 Push(Right, Needle):7	Push(Right, Needle):7	Push(Right, Needle):7	 ->Push(Right, Needle)
746 Push(Right, Needle):7	Push(Right, Needle):7	Push(Right, Needle):7	 ->Push(Right, Needle)
747 Push(Right, Needle):7	Push(Right, Needle):7	Push(Right, Needle):7	 ->Push(Right, Needle)
748 Push(Right, Needle):7	Push(Right, Needle):7	Push(Right, Needle):7	 ->Push(Right, Needle)
749 Push(Right, Needle):7	Push(Right, Needle):7	Push(Right, Needle):7	 ->Push(Right, Needle)
750 Push(Right, Needle):7	Push(Right, Needle):7	Push(Right, Needle):7	 ->Push(Right, Needle)
751 Push(Right, Needle):7	Push(Right, Needle):7	Push(Right, Needle):7	 ->Push(Right, Needle)
752 Push(Right, Needle):7	Push(Right, Needle):7	Push(Right, Needle):7	 ->Push(Right, Needle)
753 Push(Right, Needle):7	Push(Right, Needle):7	Push(Right, Needle):7	 ->Push(Right, Needle)
754 Push(Right, Needle):7	Push(Right, Needle):7	Push(Right, Needle):7	 ->Push(Right, Needle)
755 Push(Right, Needle):7	Push(Right, Needle):7	Push(Right, Needle):7	 ->Push(Right, Needle)
756 Push(Right, Needle):7	Push(Right, Needle):7	Push(Right, Needle):7	 ->Push(Right, Needle)
757 Push(Right, Needle):7	Push(Right, Needle):7	Push(Right, Needle):7	 ->Push(Right, Needle)
758 Push(Right, Needle):7	Push(Right, Needle):7	Push(Right, Needle):7	 ->Push(Right, Needle)
759 Push(Right, Needle):7	Push(Right, Needle):7	Push(Right, Needle):7	 ->Push(Right, Needle)
760 Push(Right, Needle):7	Push(Right, Needle):7	Push(Right, Needle):7	 ->Push(Right, Needle)
761 Push(Right, Needle):7	Push(Right, Needle):7	Push(Right, Needle):7	 ->Push(Right, Needle)
762 Push(Right, Needle):7	Push(Right, Needle):7	Push(Right, Needle):7	 ->Push(Right, Needle)
763 Push(Right, Needle):7	Push(Right, Needle):7	Push(Right, Needle):7	 ->Push(Right, Needle)
764 Push(Right, Needle):7	Push(Right, Needle):7	Push(Right, Needle):7	 ->Push(Right, Needle)
765 Push(Right, Needle):7	Push(Right, Needle):7	Push(Right, Needle):7	 ->Push(Right, Needle)
766 Push(Right, Needle):7	Push(Right, Needle):7	Push(Right, Needle):7	 ->Push(Right, Needle)
767 Push(Right, Needle):7	Push(Right, Needle):7	Push(Right, Needle):7	 ->Push(Right, Needle)
768 Push(Right, Needle):7	Push(Right, Needle):7	Push(Right, Needle):7	 ->Push(Right, Needle)
769 Push(Right, Needle):7	Push(Right, Needle):7	Push(Right, Needle):7	 ->Push(Right, Needle)
770 Push(Right, Needle):7	Push(Right, Needle):7	Push(Right, Needle):7	 ->Push(Right, Needle)
771 Push(Right, Needle):7	Push(Right, Needle):7	Push(Right, Needle):7	 ->Push(Right, Needle)
772 Push(Right, Needle):7	Push(Right, Needle):7	Push(Right, Needle):7	 ->Push(Right, Needle)
773 Push(Right, Needle):7	Push(Right, Needle):7	Push(Right, Needle):7	 ->Push(Right, Needle)
774 Push(Right, Needle):7	Push(Right, Needle):7	Push(Right, Needle):7	 ->Push(Right, Needle)
775 Push(Right, Needle):7	Push(Right, Needle):7	Push(Right, Needle):7	 ->Push(Right, Needle)
776 Push(Right, Needle):7	Push(Right, Needle):7	Push(Right, Needle):7	 ->Push(Right, Needle)
777 Push(Right, Needle):7	Push(Right, Needle):7	Push(Right, Needle):7	 ->Push(Right, Needle)
778 Push(Right, Needle):7	Push(Right, Needle):7	Push(Right, Needle):7	 ->Push(Right, Needle)
779 Push(Right, Needle):7	Push(Right, Needle):7	Push(Right, Needle):7	 ->Push(Right, Needle)
780 Push(Right, Needle):7	Push(Right, Needle):7	Push(Right, Needle):7	 ->Push(Right, Needle)
781 Push(Right, Needle):7	Push(Right, Needle):7	Push(Right, Needle):7	 ->Push(Right, Needle)
782 Push(Right, Needle):7	Push(Right, Needle):7	Push(Right, Needle):7	 ->Push(Right, Needle)
783 Push(Right, Needle):7	Push(Right, Needle):7	Push(Right, Needle):7	 ->Push(Right, Needle)
784 Push(Right, Needle):7	Push(Right, Needle):7	Push(Right, Needle):7	 ->Push(Right, Needle)
785 Push(Right, Needle):7	Push(Right, Needle):7	Push(Right, Needle):7	 ->Push(Right, Needle)
786 Push(Right, Needle):7	Push(Right, Needle):7	Push(Right, Needle):7	 ->Push(Right, Needle)
787 Push(Right, Needle):7	Push(Right, Needle):7	Push(Right, Needle):7	 ->Push(Right, Needle)
788 Push(Right, Needle):7	Push(Right, Needle):7	Push(Right, Needle):7	 ->Push(Right, Needle)
789 Push(Right, Needle):7	Push(Right, Needle):7	Push(Right, Needle):7	 ->Push(Right, Needle)
790 Push(Right, Needle):7	Push(Right, Needle):7	Push(Right, Needle):7	 ->Push(Right, Needle)
791 Push(Right, Needle):7	Push(Right, Needle):7	Push(Right, Needle):7	 ->Push(Right, Needle)
792 Push(Right, Needle):7	Push(Right, Needle):7	Push(Right, Needle):7	 ->Push(Right, Needle)
793 Push(Right, Needle):7	Push(Right, Needle):7	Push(Right, Needle):7	 ->Push(Right, Needle)
794 Push(Right, Needle):7	Push(Right, Needle):7	Push(Right, Needle):7	 ->Push(Right, Needle)
795 Push(Right, Needle):7	Push(Right, Needle):7	Push(Right, Needle):7	 ->Push(Right, Needle)
796 Push(Right, Needle):7	Push(Right, Needle):7	Push(Right, Needle):7	 ->Push(Right, Needle)
797 Push(Right, Needle):7	Push(Right, Needle):7	Push(Right, Needle):7	 ->Push(Right, Needle)
798 Push(Right, Needle):7	Push(Right, Needle):7	Push(Right, Needle):7	 ->Push(Right, Needle)
799 Push(Right, Needle):7	Push(Right, Needle):7	Push(Right, Needle):7	 ->Push(Right, Needle)
800 Push(Right, Needle):7	Push(Right, Needle):7	Push(Right, Needle):7	 ->Push(Right, Needle)
801 Push(Right, Needle):7	Push(Right, Needle):7	Push(Right, Needle):7	 ->Push(Right, Needle)
802 Push(Right, Needle):7	Push(Right, Needle):7	Push(Right, Needle):7	 ->Push(Right, Needle)
803 Push(Right, Needle):7	Push(Right, Needle):7	Push(Right, Needle):7	 ->Push(Right, Needle)
804 Push(Right, Needle):7	Push(Right, Needle):7	Push(Right, Needle):7	 ->Push(Right, Needle)
805 Push(Right, Needle):7	Push(Right, Needle):7	Push(Right, Needle):7	 ->Push(Right, Needle)
806 Push(Right, Needle):7	Push(Right, Needle):7	Push(Right, Needle):7	 ->Push(Right, Needle)
807 Push(Right, Needle):7	Push(Right, Needle):7	Push(Right, Needle):7	 ->Push(Right, Needle)
808 Push(Right, Needle):7	Push(Right, Needle):7	Push(Right, Needle):7	 ->Push(Right, Needle)
809 Push(Right, Needle):7	Push(Right, Needle):7	Push(Right, Needle):7	 ->Push(Right, Needle)
810 Push(Right, Needle):7	Push(Right, Needle):7	Push(Right, Needle):7	 ->Push(Right, Needle)
811 Push(Right, Needle):7	Push(Right, Needle):7	Push(Right, Needle):7	 ->Push(Right, Needle)
812 Push(Right, Needle):7	Push(Right, Needle):7	Push(Right, Needle):7	 ->Push(Right, Needle)
813 Push(Right, Needle):7	Push(Right, Needle):7	Push(Right, Needle):7	 ->Push(Right, Needle)
814 Push(Right, Needle):7	Push(Right, Needle):7	Push(Right, Needle):7	 ->Push(Right, Needle)
815 Push(Right, Needle):7	Push(Right, Needle):7	Push(Right, Needle):7	 ->Push(Right, Needle)
816 Push(Right, Needle):7	Push(Right, Needle):7	Push(Right, Needle):7	 ->Push(Right, Needle)
817 Push(Right, Needle):7	Push(Right, Needle):7	Push(Right, Needle):7	 ->Push(Right, Needle)
818 Push(Right, Needle):7	Push(Right, Needle):7	Push(Right, Needle):7	 ->Push(Right, Needle)
819 Push(Right, Needle):7	Push(Right, Needle):7	Push(Right, Needle):7	 ->Push(Right, Needle)
820 Push(Right, Needle):7	Push(Right, Needle):7	Push(Right, Needle):7	 ->Push(Right, Needle)
821 Push(Right, Needle):7	Push(Right, Needle):7	Push(Right, Needle):7	 ->Push(Right, Needle)
822 Push(Right, Needle):7	Push(Right, Needle):7	Push(Right, Needle):7	 ->Push(Right, Needle)
823 Push(Right, Needle):7	Push(Right, Needle):7	Push(Right, Needle):7	 ->Push(Right, Needle)
824 Push(Right, Needle):7	Push(Right, Needle):7	Push(Right, Needle):7	 ->Push(Right, Needle)
825 Push(Right, Needle):7	Push(Right, Needle):7	Push(Right, Needle):7	 ->Push(Right, Needle)
826 Push(Right, Needle):7	Push(Right, Needle):7	Push(Right, Needle):7	 ->Push(Right, Needle)
827 Push(Right, Needle):7	Push(Right, Needle):7	Push(Right, Needle):7	 ->Push(Right, Needle)
828 Push(Right, Needle):7	Push(Right, Needle):7	Push(Right, Needle):7	 ->Push(Right, Needle)
829 Push(Right, Needle):7	Push(Right, Needle):7	Push(Right, Needle):7	 ->Push(Right, Needle)
830 Push(Right, Needle):7	Push(Right, Needle):7	Push(Right, Needle):7	 ->Push(Right, Needle)
831 Push(Right, Needle):7	Push(Right, Needle):7	Push(Right, Needle):7	 ->Push(Right, Needle)
832 Push(Right, Needle):7	Push(Right, Needle):7	Push(Right, Needle):7	 ->Push(Right, Needle)
833 Push(Right, Needle):7	Push(Right, Needle):7	Push(Right, Needle):7	 ->Push(Right, Needle)
834 Push(Right, Needle):7	Push(Right, Needle):7	Push(Right, Needle):7	 ->Push(Right, Needle)
835 Grasp(Left, Needle):0	Push(Right, Needle):7	Push(Right, Needle):7	 ->Push(Right, Needle)
836 Grasp(Left, Needle):0	Push(Right, Needle):7	Push(Right, Needle):7	 ->Push(Right, Needle)
837 Grasp(Left, Needle):0	Push(Right, Needle):7	Push(Right, Needle):7	 ->Push(Right, Needle)
838 Grasp(Left, Needle):0	Push(Right, Needle):7	Touch(Left, Needle):9	 ->Grasp(Left, Needle)
839 Grasp(Left, Needle):0	Push(Right, Needle):7	Touch(Left, Needle):9	 ->Grasp(Left, Needle)
840 Grasp(Left, Needle):0	Push(Right, Needle):7	Touch(Left, Needle):9	 ->Grasp(Left, Needle)
841 Grasp(Left, Needle):0	Push(Right, Needle):7	Touch(Left, Needle):9	 ->Grasp(Left, Needle)
842 Grasp(Left, Needle):0	Push(Right, Needle):7	Touch(Left, Needle):9	 ->Grasp(Left, Needle)
843 Grasp(Left, Needle):0	Push(Right, Needle):7	Touch(Left, Needle):9	 ->Grasp(Left, Needle)
844 Grasp(Left, Needle):0	Push(Right, Needle):7	Touch(Left, Needle):9	 ->Grasp(Left, Needle)
845 Grasp(Left, Needle):0	Push(Right, Needle):7	Touch(Left, Needle):9	 ->Grasp(Left, Needle)
846 Grasp(Left, Needle):0	Push(Right, Needle):7	Touch(Left, Needle):9	 ->Grasp(Left, Needle)
847 Grasp(Left, Needle):0	Push(Right, Needle):7	Touch(Left, Needle):9	 ->Grasp(Left, Needle)
848 Grasp(Left, Needle):0	Push(Right, Needle):7	Touch(Left, Needle):9	 ->Grasp(Left, Needle)
849 Grasp(Left, Needle):0	Push(Right, Needle):7	Touch(Left, Needle):9	 ->Grasp(Left, Needle)
850 Grasp(Left, Needle):0	Push(Right, Needle):7	Touch(Left, Needle):9	 ->Grasp(Left, Needle)
851 Grasp(Left, Needle):0	Push(Right, Needle):7	Touch(Left, Needle):9	 ->Grasp(Left, Needle)
852 Grasp(Left, Needle):0	Push(Right, Needle):7	Touch(Left, Needle):9	 ->Grasp(Left, Needle)
853 Grasp(Left, Needle):0	Push(Right, Needle):7	Touch(Left, Needle):9	 ->Grasp(Left, Needle)
854 Grasp(Left, Needle):0	Push(Right, Needle):7	Touch(Left, Needle):9	 ->Grasp(Left, Needle)
855 Grasp(Left, Needle):0	Push(Right, Needle):7	Touch(Left, Needle):9	 ->Grasp(Left, Needle)
856 Grasp(Left, Needle):0	Push(Right, Needle):7	Touch(Left, Needle):9	 ->Grasp(Left, Needle)
857 Grasp(Left, Needle):0	Push(Right, Needle):7	Touch(Left, Needle):9	 ->Grasp(Left, Needle)
858 Grasp(Left, Needle):0	Push(Right, Needle):7	Touch(Left, Needle):9	 ->Grasp(Left, Needle)
859 Grasp(Left, Needle):0	Push(Right, Needle):7	Touch(Left, Needle):9	 ->Grasp(Left, Needle)
860 Grasp(Left, Needle):0	Push(Right, Needle):7	Touch(Left, Needle):9	 ->Grasp(Left, Needle)
861 Grasp(Left, Needle):0	Push(Right, Needle):7	Touch(Left, Needle):9	 ->Grasp(Left, Needle)
862 Grasp(Left, Needle):0	Push(Right, Needle):7	Touch(Left, Needle):9	 ->Grasp(Left, Needle)
863 Grasp(Left, Needle):0	Push(Right, Needle):7	Touch(Left, Needle):9	 ->Grasp(Left, Needle)
864 Grasp(Left, Needle):0	Push(Right, Needle):7	Touch(Left, Needle):9	 ->Grasp(Left, Needle)
865 Grasp(Left, Needle):0	Push(Right, Needle):7	Touch(Left, Needle):9	 ->Grasp(Left, Needle)
866 Grasp(Left, Needle):0	Push(Right, Needle):7	Touch(Left, Needle):9	 ->Grasp(Left, Needle)
867 Grasp(Left, Needle):0	Grasp(Left, Needle):0	Touch(Left, Needle):9	 ->Grasp(Left, Needle)
868 Grasp(Left, Needle):0	Grasp(Left, Needle):0	Touch(Left, Needle):9	 ->Grasp(Left, Needle)
869 Grasp(Left, Needle):0	Grasp(Left, Needle):0	Touch(Left, Needle):9	 ->Grasp(Left, Needle)
870 Grasp(Left, Needle):0	Grasp(Left, Needle):0	Grasp(Left, Needle):0	 ->Grasp(Left, Needle)
871 Grasp(Left, Needle):0	Grasp(Left, Needle):0	Grasp(Left, Needle):0	 ->Grasp(Left, Needle)
872 Grasp(Left, Needle):0	Grasp(Left, Needle):0	Grasp(Left, Needle):0	 ->Grasp(Left, Needle)
873 Grasp(Left, Needle):0	Grasp(Left, Needle):0	Grasp(Left, Needle):0	 ->Grasp(Left, Needle)
874 Grasp(Left, Needle):0	Grasp(Left, Needle):0	Grasp(Left, Needle):0	 ->Grasp(Left, Needle)
875 Grasp(Left, Needle):0	Grasp(Left, Needle):0	Grasp(Left, Needle):0	 ->Grasp(Left, Needle)
876 Grasp(Left, Needle):0	Grasp(Left, Needle):0	Grasp(Left, Needle):0	 ->Grasp(Left, Needle)
877 Grasp(Left, Needle):0	Grasp(Left, Needle):0	Grasp(Left, Needle):0	 ->Grasp(Left, Needle)
878 Grasp(Left, Needle):0	Grasp(Left, Needle):0	Grasp(Left, Needle):0	 ->Grasp(Left, Needle)
879 Grasp(Left, Needle):0	Grasp(Left, Needle):0	Grasp(Left, Needle):0	 ->Grasp(Left, Needle)
880 Grasp(Left, Needle):0	Grasp(Left, Needle):0	Grasp(Left, Needle):0	 ->Grasp(Left, Needle)
881 Grasp(Left, Needle):0	Grasp(Left, Needle):0	Grasp(Left, Needle):0	 ->Grasp(Left, Needle)
882 Grasp(Left, Needle):0	Grasp(Left, Needle):0	Grasp(Left, Needle):0	 ->Grasp(Left, Needle)
883 Pull(Left, Needle):10	Release(Right, Needle):2	Release(Right, Needle):2	 ->Release(Right, Needle)
884 Pull(Left, Needle):10	Release(Right, Needle):2	Release(Right, Needle):2	 ->Release(Right, Needle)
885 Pull(Left, Needle):10	Release(Right, Needle):2	Release(Right, Needle):2	 ->Release(Right, Needle)
886 Pull(Left, Needle):10	Release(Right, Needle):2	Release(Right, Needle):2	 ->Release(Right, Needle)
887 Pull(Left, Needle):10	Release(Right, Needle):2	Release(Right, Needle):2	 ->Release(Right, Needle)
888 Pull(Left, Needle):10	Release(Right, Needle):2	Untouch(Right, Needle):3	 ->Pull(Left, Needle)
889 Pull(Left, Needle):10	Release(Right, Needle):2	Untouch(Right, Needle):3	 ->Pull(Left, Needle)
890 Pull(Left, Needle):10	Release(Right, Needle):2	Untouch(Right, Needle):3	 ->Pull(Left, Needle)
891 Pull(Left, Needle):10	Release(Right, Needle):2	Untouch(Right, Needle):3	 ->Pull(Left, Needle)
892 Pull(Left, Needle):10	Pull(Left, Needle):10	Untouch(Right, Needle):3	 ->Pull(Left, Needle)
893 Pull(Left, Needle):10	Pull(Left, Needle):10	Pull(Left, Needle):10	 ->Pull(Left, Needle)
894 Pull(Left, Needle):10	Pull(Left, Needle):10	Pull(Left, Needle):10	 ->Pull(Left, Needle)
895 Pull(Left, Needle):10	Pull(Left, Needle):10	Pull(Left, Needle):10	 ->Pull(Left, Needle)
896 Pull(Left, Needle):10	Pull(Left, Needle):10	Pull(Left, Needle):10	 ->Pull(Left, Needle)
897 Pull(Left, Needle):10	Pull(Left, Needle):10	Pull(Left, Needle):10	 ->Pull(Left, Needle)
898 Pull(Left, Needle):10	Pull(Left, Needle):10	Pull(Left, Needle):10	 ->Pull(Left, Needle)
899 Pull(Left, Needle):10	Pull(Left, Needle):10	Pull(Left, Needle):10	 ->Pull(Left, Needle)
900 Pull(Left, Needle):10	Pull(Left, Needle):10	Pull(Left, Needle):10	 ->Pull(Left, Needle)
901 Pull(Left, Needle):10	Pull(Left, Needle):10	Pull(Left, Needle):10	 ->Pull(Left, Needle)
902 Pull(Left, Needle):10	Pull(Left, Needle):10	Pull(Left, Needle):10	 ->Pull(Left, Needle)
903 Pull(Left, Needle):10	Pull(Left, Needle):10	Pull(Left, Needle):10	 ->Pull(Left, Needle)
904 Pull(Left, Needle):10	Pull(Left, Needle):10	Pull(Left, Needle):10	 ->Pull(Left, Needle)
905 Pull(Left, Needle):10	Pull(Left, Needle):10	Pull(Left, Needle):10	 ->Pull(Left, Needle)
906 Pull(Left, Needle):10	Pull(Left, Needle):10	Pull(Left, Needle):10	 ->Pull(Left, Needle)
907 Pull(Left, Needle):10	Pull(Left, Needle):10	Pull(Left, Needle):10	 ->Pull(Left, Needle)
908 Pull(Left, Needle):10	Pull(Left, Needle):10	Pull(Left, Needle):10	 ->Pull(Left, Needle)
909 Pull(Left, Needle):10	Pull(Left, Needle):10	Pull(Left, Needle):10	 ->Pull(Left, Needle)
910 Pull(Left, Needle):10	Pull(Left, Needle):10	Pull(Left, Needle):10	 ->Pull(Left, Needle)
911 Pull(Left, Needle):10	Pull(Left, Needle):10	Pull(Left, Needle):10	 ->Pull(Left, Needle)
912 Pull(Left, Needle):10	Pull(Left, Needle):10	Pull(Left, Needle):10	 ->Pull(Left, Needle)
913 Pull(Left, Needle):10	Pull(Left, Needle):10	Pull(Left, Needle):10	 ->Pull(Left, Needle)
914 Pull(Left, Needle):10	Pull(Left, Needle):10	Pull(Left, Needle):10	 ->Pull(Left, Needle)
915 Pull(Left, Needle):10	Pull(Left, Needle):10	Pull(Left, Needle):10	 ->Pull(Left, Needle)
916 Pull(Left, Needle):10	Pull(Left, Needle):10	Pull(Left, Needle):10	 ->Pull(Left, Needle)
917 Pull(Left, Needle):10	Pull(Left, Needle):10	Pull(Left, Needle):10	 ->Pull(Left, Needle)
918 Pull(Left, Needle):10	Pull(Left, Needle):10	Pull(Left, Needle):10	 ->Pull(Left, Needle)
919 Pull(Left, Needle):10	Pull(Left, Needle):10	Pull(Left, Needle):10	 ->Pull(Left, Needle)
920 Pull(Left, Needle):10	Pull(Left, Needle):10	Pull(Left, Needle):10	 ->Pull(Left, Needle)
921 Pull(Left, Needle):10	Pull(Left, Needle):10	Pull(Left, Needle):10	 ->Pull(Left, Needle)
922 Pull(Left, Needle):10	Pull(Left, Needle):10	Pull(Left, Needle):10	 ->Pull(Left, Needle)
923 Pull(Left, Needle):10	Pull(Left, Needle):10	Pull(Left, Needle):10	 ->Pull(Left, Needle)
924 Pull(Left, Needle):10	Pull(Left, Needle):10	Pull(Left, Needle):10	 ->Pull(Left, Needle)
925 Pull(Left, Needle):10	Pull(Left, Needle):10	Pull(Left, Needle):10	 ->Pull(Left, Needle)
926 Pull(Left, Needle):10	Pull(Left, Needle):10	Pull(Left, Needle):10	 ->Pull(Left, Needle)
927 Pull(Left, Needle):10	Pull(Left, Needle):10	Pull(Left, Needle):10	 ->Pull(Left, Needle)
928 Pull(Left, Needle):10	Pull(Left, Needle):10	Pull(Left, Needle):10	 ->Pull(Left, Needle)
929 Pull(Left, Needle):10	Pull(Left, Needle):10	Pull(Left, Needle):10	 ->Pull(Left, Needle)
930 Pull(Left, Needle):10	Pull(Left, Needle):10	Pull(Left, Needle):10	 ->Pull(Left, Needle)
931 Pull(Left, Needle):10	Pull(Left, Needle):10	Pull(Left, Needle):10	 ->Pull(Left, Needle)
932 Pull(Left, Needle):10	Pull(Left, Needle):10	Pull(Left, Needle):10	 ->Pull(Left, Needle)
933 Pull(Left, Needle):10	Pull(Left, Needle):10	Pull(Left, Needle):10	 ->Pull(Left, Needle)
934 Pull(Left, Needle):10	Pull(Left, Needle):10	Pull(Left, Needle):10	 ->Pull(Left, Needle)
935 Pull(Left, Needle):10	Pull(Left, Needle):10	Pull(Left, Needle):10	 ->Pull(Left, Needle)
936 Pull(Left, Needle):10	Pull(Left, Needle):10	Pull(Left, Needle):10	 ->Pull(Left, Needle)
937 Pull(Left, Needle):10	Pull(Left, Needle):10	Pull(Left, Needle):10	 ->Pull(Left, Needle)
938 Pull(Left, Needle):10	Pull(Left, Needle):10	Pull(Left, Needle):10	 ->Pull(Left, Needle)
939 Pull(Left, Needle):10	Pull(Left, Needle):10	Pull(Left, Needle):10	 ->Pull(Left, Needle)
940 Pull(Left, Needle):10	Pull(Left, Needle):10	Pull(Left, Needle):10	 ->Pull(Left, Needle)
941 Pull(Left, Needle):10	Pull(Left, Needle):10	Pull(Left, Needle):10	 ->Pull(Left, Needle)
942 Pull(Left, Needle):10	Pull(Left, Needle):10	Pull(Left, Needle):10	 ->Pull(Left, Needle)
943 Pull(Left, Needle):10	Pull(Left, Needle):10	Pull(Left, Needle):10	 ->Pull(Left, Needle)
944 Pull(Left, Needle):10	Pull(Left, Needle):10	Pull(Left, Needle):10	 ->Pull(Left, Needle)
945 Pull(Left, Needle):10	Pull(Left, Needle):10	Pull(Left, Needle):10	 ->Pull(Left, Needle)
946 Pull(Left, Needle):10	Pull(Left, Needle):10	Pull(Left, Needle):10	 ->Pull(Left, Needle)
947 Pull(Left, Needle):10	Pull(Left, Needle):10	Pull(Left, Needle):10	 ->Pull(Left, Needle)
948 Pull(Left, Needle):10	Pull(Left, Needle):10	Pull(Left, Needle):10	 ->Pull(Left, Needle)
949 Pull(Left, Needle):10	Pull(Left, Needle):10	Pull(Left, Needle):10	 ->Pull(Left, Needle)
950 Pull(Left, Needle):10	Pull(Left, Needle):10	Pull(Left, Needle):10	 ->Pull(Left, Needle)
951 Pull(Left, Needle):10	Pull(Left, Needle):10	Pull(Left, Needle):10	 ->Pull(Left, Needle)
952 Pull(Left, Needle):10	Pull(Left, Needle):10	Pull(Left, Needle):10	 ->Pull(Left, Needle)
953 Pull(Left, Needle):10	Pull(Left, Needle):10	Pull(Left, Needle):10	 ->Pull(Left, Needle)
954 Pull(Left, Needle):10	Pull(Left, Needle):10	Pull(Left, Needle):10	 ->Pull(Left, Needle)
955 Pull(Left, Needle):10	Pull(Left, Needle):10	Pull(Left, Needle):10	 ->Pull(Left, Needle)
956 Pull(Left, Needle):10	Pull(Left, Needle):10	Pull(Left, Needle):10	 ->Pull(Left, Needle)
957 Pull(Left, Needle):10	Pull(Left, Needle):10	Pull(Left, Needle):10	 ->Pull(Left, Needle)
958 Pull(Left, Needle):10	Pull(Left, Needle):10	Pull(Left, Needle):10	 ->Pull(Left, Needle)
959 Pull(Left, Needle):10	Pull(Left, Needle):10	Pull(Left, Needle):10	 ->Pull(Left, Needle)
960 Pull(Left, Needle):10	Pull(Left, Needle):10	Pull(Left, Needle):10	 ->Pull(Left, Needle)
961 Pull(Left, Needle):10	Pull(Left, Needle):10	Pull(Left, Needle):10	 ->Pull(Left, Needle)
962 Pull(Left, Needle):10	Pull(Left, Needle):10	Pull(Left, Needle):10	 ->Pull(Left, Needle)
963 Pull(Left, Needle):10	Pull(Left, Needle):10	Pull(Left, Needle):10	 ->Pull(Left, Needle)
964 Pull(Left, Needle):10	Pull(Left, Needle):10	Pull(Left, Needle):10	 ->Pull(Left, Needle)
965 Pull(Left, Needle):10	Pull(Left, Needle):10	Pull(Left, Needle):10	 ->Pull(Left, Needle)
966 Pull(Left, Needle):10	Pull(Left, Needle):10	Pull(Left, Needle):10	 ->Pull(Left, Needle)
967 Pull(Left, Needle):10	Pull(Left, Needle):10	Pull(Left, Needle):10	 ->Pull(Left, Needle)
968 Pull(Left, Needle):10	Pull(Left, Needle):10	Pull(Left, Needle):10	 ->Pull(Left, Needle)
969 Pull(Left, Needle):10	Pull(Left, Needle):10	Pull(Left, Needle):10	 ->Pull(Left, Needle)
970 Pull(Left, Needle):10	Pull(Left, Needle):10	Pull(Left, Needle):10	 ->Pull(Left, Needle)
971 Pull(Left, Needle):10	Pull(Left, Needle):10	Pull(Left, Needle):10	 ->Pull(Left, Needle)
972 Pull(Left, Needle):10	Pull(Left, Needle):10	Pull(Left, Needle):10	 ->Pull(Left, Needle)
973 Pull(Left, Needle):10	Pull(Left, Needle):10	Pull(Left, Needle):10	 ->Pull(Left, Needle)
974 Pull(Left, Needle):10	Pull(Left, Needle):10	Pull(Left, Needle):10	 ->Pull(Left, Needle)
975 Pull(Left, Needle):10	Pull(Left, Needle):10	Pull(Left, Needle):10	 ->Pull(Left, Needle)
976 Pull(Left, Needle):10	Pull(Left, Needle):10	Pull(Left, Needle):10	 ->Pull(Left, Needle)
977 Pull(Left, Needle):10	Pull(Left, Needle):10	Pull(Left, Needle):10	 ->Pull(Left, Needle)
978 Pull(Left, Needle):10	Pull(Left, Needle):10	Pull(Left, Needle):10	 ->Pull(Left, Needle)
979 Pull(Left, Needle):10	Pull(Left, Needle):10	Pull(Left, Needle):10	 ->Pull(Left, Needle)
980 Pull(Left, Needle):10	Pull(Left, Needle):10	Pull(Left, Needle):10	 ->Pull(Left, Needle)
981 Pull(Left, Needle):10	Pull(Left, Needle):10	Pull(Left, Needle):10	 ->Pull(Left, Needle)
982 Pull(Left, Needle):10	Pull(Left, Needle):10	Pull(Left, Needle):10	 ->Pull(Left, Needle)
983 Pull(Left, Needle):10	Pull(Left, Needle):10	Touch(Right, Needle):4	 ->Pull(Left, Needle)
984 Pull(Left, Needle):10	Pull(Left, Needle):10	Touch(Right, Needle):4	 ->Pull(Left, Needle)
985 Pull(Left, Needle):10	Pull(Left, Needle):10	Touch(Right, Needle):4	 ->Pull(Left, Needle)
986 Pull(Left, Needle):10	Pull(Left, Needle):10	Touch(Right, Needle):4	 ->Pull(Left, Needle)
987 Pull(Left, Needle):10	Pull(Left, Needle):10	Touch(Right, Needle):4	 ->Pull(Left, Needle)
988 Pull(Left, Needle):10	Pull(Left, Needle):10	Touch(Right, Needle):4	 ->Pull(Left, Needle)
989 Pull(Left, Needle):10	Pull(Left, Needle):10	Touch(Right, Needle):4	 ->Pull(Left, Needle)
990 Pull(Left, Needle):10	Pull(Left, Needle):10	Touch(Right, Needle):4	 ->Pull(Left, Needle)
991 Pull(Left, Needle):10	Pull(Left, Needle):10	Touch(Right, Needle):4	 ->Pull(Left, Needle)
992 Pull(Left, Needle):10	Pull(Left, Needle):10	Touch(Right, Needle):4	 ->Pull(Left, Needle)
993 Pull(Left, Needle):10	Pull(Left, Needle):10	Touch(Right, Needle):4	 ->Pull(Left, Needle)
994 Pull(Left, Needle):10	Pull(Left, Needle):10	Touch(Right, Needle):4	 ->Pull(Left, Needle)
995 Pull(Left, Needle):10	Pull(Left, Needle):10	Touch(Right, Needle):4	 ->Pull(Left, Needle)
996 Pull(Left, Needle):10	Pull(Left, Needle):10	Touch(Right, Needle):4	 ->Pull(Left, Needle)
997 Pull(Left, Needle):10	Pull(Left, Needle):10	Touch(Right, Needle):4	 ->Pull(Left, Needle)
998 Pull(Left, Needle):10	Pull(Left, Needle):10	Touch(Right, Needle):4	 ->Pull(Left, Needle)
999 Pull(Left, Needle):10	Pull(Left, Needle):10	Touch(Right, Needle):4	 ->Pull(Left, Needle)
1000 Pull(Left, Needle):10	Pull(Left, Needle):10	Touch(Right, Needle):4	 ->Pull(Left, Needle)
1001 Pull(Left, Needle):10	Pull(Left, Needle):10	Touch(Right, Needle):4	 ->Pull(Left, Needle)
1002 Pull(Left, Needle):10	Pull(Left, Needle):10	Touch(Right, Needle):4	 ->Pull(Left, Needle)
1003 Pull(Left, Needle):10	Pull(Left, Needle):10	Touch(Right, Needle):4	 ->Pull(Left, Needle)
1004 Pull(Left, Needle):10	Pull(Left, Needle):10	Touch(Right, Needle):4	 ->Pull(Left, Needle)
1005 Pull(Left, Needle):10	Pull(Left, Needle):10	Touch(Right, Needle):4	 ->Pull(Left, Needle)
1006 Pull(Left, Needle):10	Pull(Left, Needle):10	Touch(Right, Needle):4	 ->Pull(Left, Needle)
1007 Pull(Left, Needle):10	Pull(Left, Needle):10	Touch(Right, Needle):4	 ->Pull(Left, Needle)
1008 Pull(Left, Needle):10	Pull(Left, Needle):10	Touch(Right, Needle):4	 ->Pull(Left, Needle)
1009 Pull(Left, Needle):10	Pull(Left, Needle):10	Touch(Right, Needle):4	 ->Pull(Left, Needle)
1010 Pull(Left, Needle):10	Pull(Left, Needle):10	Touch(Right, Needle):4	 ->Pull(Left, Needle)
1011 Pull(Left, Needle):10	Pull(Left, Needle):10	Touch(Right, Needle):4	 ->Pull(Left, Needle)
1012 Pull(Left, Needle):10	Pull(Left, Needle):10	Touch(Right, Needle):4	 ->Pull(Left, Needle)
1013 Pull(Left, Needle):10	Pull(Left, Needle):10	Touch(Right, Needle):4	 ->Pull(Left, Needle)
1014 Pull(Left, Needle):10	Pull(Left, Needle):10	Touch(Right, Needle):4	 ->Pull(Left, Needle)
1015 Grasp(Right, Needle):1	Pull(Left, Needle):10	Touch(Right, Needle):4	 ->Grasp(Right, Needle)
1016 Grasp(Right, Needle):1	Pull(Left, Needle):10	Touch(Right, Needle):4	 ->Grasp(Right, Needle)
1017 Grasp(Right, Needle):1	Pull(Left, Needle):10	Touch(Right, Needle):4	 ->Grasp(Right, Needle)
1018 Grasp(Right, Needle):1	Pull(Left, Needle):10	Touch(Right, Needle):4	 ->Grasp(Right, Needle)
1019 Grasp(Right, Needle):1	Pull(Left, Needle):10	Touch(Right, Needle):4	 ->Grasp(Right, Needle)
1020 Grasp(Right, Needle):1	Pull(Left, Needle):10	Touch(Right, Needle):4	 ->Grasp(Right, Needle)
1021 Grasp(Right, Needle):1	Pull(Left, Needle):10	Touch(Right, Needle):4	 ->Grasp(Right, Needle)
1022 Grasp(Right, Needle):1	Pull(Left, Needle):10	Touch(Right, Needle):4	 ->Grasp(Right, Needle)
1023 Grasp(Right, Needle):1	Pull(Left, Needle):10	Touch(Right, Needle):4	 ->Grasp(Right, Needle)
1024 Grasp(Right, Needle):1	Pull(Left, Needle):10	Touch(Right, Needle):4	 ->Grasp(Right, Needle)
1025 Grasp(Right, Needle):1	Pull(Left, Needle):10	Touch(Right, Needle):4	 ->Grasp(Right, Needle)
1026 Grasp(Right, Needle):1	Pull(Left, Needle):10	Touch(Right, Needle):4	 ->Grasp(Right, Needle)
1027 Grasp(Right, Needle):1	Pull(Left, Needle):10	Touch(Right, Needle):4	 ->Grasp(Right, Needle)
1028 Grasp(Right, Needle):1	Pull(Left, Needle):10	Touch(Right, Needle):4	 ->Grasp(Right, Needle)
1029 Grasp(Right, Needle):1	Pull(Left, Needle):10	Touch(Right, Needle):4	 ->Grasp(Right, Needle)
1030 Grasp(Right, Needle):1	Pull(Left, Needle):10	Touch(Right, Needle):4	 ->Grasp(Right, Needle)
1031 Grasp(Right, Needle):1	Pull(Left, Needle):10	Touch(Right, Needle):4	 ->Grasp(Right, Needle)
1032 Grasp(Right, Needle):1	Pull(Left, Needle):10	Touch(Right, Needle):4	 ->Grasp(Right, Needle)
1033 Grasp(Right, Needle):1	Pull(Left, Needle):10	Touch(Right, Needle):4	 ->Grasp(Right, Needle)
1034 Grasp(Right, Needle):1	Pull(Left, Needle):10	Touch(Right, Needle):4	 ->Grasp(Right, Needle)
1035 Grasp(Right, Needle):1	Pull(Left, Needle):10	Touch(Right, Needle):4	 ->Grasp(Right, Needle)
1036 Grasp(Right, Needle):1	Pull(Left, Needle):10	Touch(Right, Needle):4	 ->Grasp(Right, Needle)
1037 Grasp(Right, Needle):1	Pull(Left, Needle):10	Touch(Right, Needle):4	 ->Grasp(Right, Needle)
1038 Grasp(Right, Needle):1	Pull(Left, Needle):10	Touch(Right, Needle):4	 ->Grasp(Right, Needle)
1039 Grasp(Right, Needle):1	Pull(Left, Needle):10	Touch(Right, Needle):4	 ->Grasp(Right, Needle)
1040 Grasp(Right, Needle):1	Pull(Left, Needle):10	Touch(Right, Needle):4	 ->Grasp(Right, Needle)
1041 Grasp(Right, Needle):1	Pull(Left, Needle):10	Touch(Right, Needle):4	 ->Grasp(Right, Needle)
1042 Grasp(Right, Needle):1	Pull(Left, Needle):10	Touch(Right, Needle):4	 ->Grasp(Right, Needle)
1043 Grasp(Right, Needle):1	Pull(Left, Needle):10	Touch(Right, Needle):4	 ->Grasp(Right, Needle)
1044 Grasp(Right, Needle):1	Pull(Left, Needle):10	Touch(Right, Needle):4	 ->Grasp(Right, Needle)
1045 Grasp(Right, Needle):1	Pull(Left, Needle):10	Touch(Right, Needle):4	 ->Grasp(Right, Needle)
1046 Grasp(Right, Needle):1	Pull(Left, Needle):10	Touch(Right, Needle):4	 ->Grasp(Right, Needle)
1047 Grasp(Right, Needle):1	Pull(Left, Needle):10	Touch(Right, Needle):4	 ->Grasp(Right, Needle)
1048 Grasp(Right, Needle):1	Pull(Left, Needle):10	Touch(Right, Needle):4	 ->Grasp(Right, Needle)
1049 Grasp(Right, Needle):1	Pull(Left, Needle):10	Touch(Right, Needle):4	 ->Grasp(Right, Needle)
1050 Grasp(Right, Needle):1	Pull(Left, Needle):10	Touch(Right, Needle):4	 ->Grasp(Right, Needle)
1051 Grasp(Right, Needle):1	Pull(Left, Needle):10	Touch(Right, Needle):4	 ->Grasp(Right, Needle)
1052 Grasp(Right, Needle):1	Pull(Left, Needle):10	Touch(Right, Needle):4	 ->Grasp(Right, Needle)
1053 Grasp(Right, Needle):1	Pull(Left, Needle):10	Touch(Right, Needle):4	 ->Grasp(Right, Needle)
1054 Grasp(Right, Needle):1	Pull(Left, Needle):10	Touch(Right, Needle):4	 ->Grasp(Right, Needle)
1055 Grasp(Right, Needle):1	Pull(Left, Needle):10	Touch(Right, Needle):4	 ->Grasp(Right, Needle)
1056 Grasp(Right, Needle):1	Pull(Left, Needle):10	Touch(Right, Needle):4	 ->Grasp(Right, Needle)
1057 Grasp(Right, Needle):1	Pull(Left, Needle):10	Touch(Right, Needle):4	 ->Grasp(Right, Needle)
1058 Grasp(Right, Needle):1	Pull(Left, Needle):10	Touch(Right, Needle):4	 ->Grasp(Right, Needle)
1059 Grasp(Right, Needle):1	Pull(Left, Needle):10	Touch(Right, Needle):4	 ->Grasp(Right, Needle)
1060 Grasp(Right, Needle):1	Pull(Left, Needle):10	Touch(Right, Needle):4	 ->Grasp(Right, Needle)
1061 Grasp(Right, Needle):1	Pull(Left, Needle):10	Touch(Right, Needle):4	 ->Grasp(Right, Needle)
1062 Grasp(Right, Needle):1	Pull(Left, Needle):10	Touch(Right, Needle):4	 ->Grasp(Right, Needle)
1063 Grasp(Right, Needle):1	Pull(Left, Needle):10	Touch(Right, Needle):4	 ->Grasp(Right, Needle)
1064 Grasp(Right, Needle):1	Pull(Left, Needle):10	Touch(Right, Needle):4	 ->Grasp(Right, Needle)
1065 Grasp(Right, Needle):1	Pull(Left, Needle):10	Touch(Right, Needle):4	 ->Grasp(Right, Needle)
1066 Grasp(Right, Needle):1	Pull(Left, Needle):10	Touch(Right, Needle):4	 ->Grasp(Right, Needle)
1067 Grasp(Right, Needle):1	Pull(Left, Needle):10	Touch(Right, Needle):4	 ->Grasp(Right, Needle)
1068 Grasp(Right, Needle):1	Pull(Left, Needle):10	Touch(Right, Needle):4	 ->Grasp(Right, Needle)
1069 Grasp(Right, Needle):1	Pull(Left, Needle):10	Touch(Right, Needle):4	 ->Grasp(Right, Needle)
1070 Grasp(Right, Needle):1	Pull(Left, Needle):10	Touch(Right, Needle):4	 ->Grasp(Right, Needle)
1071 Grasp(Right, Needle):1	Pull(Left, Needle):10	Touch(Right, Needle):4	 ->Grasp(Right, Needle)
1072 Grasp(Right, Needle):1	Pull(Left, Needle):10	Touch(Right, Needle):4	 ->Grasp(Right, Needle)
1073 Grasp(Right, Needle):1	Pull(Left, Needle):10	Touch(Right, Needle):4	 ->Grasp(Right, Needle)
1074 Grasp(Right, Needle):1	Pull(Left, Needle):10	Touch(Right, Needle):4	 ->Grasp(Right, Needle)
1075 Grasp(Right, Needle):1	Pull(Left, Needle):10	Touch(Right, Needle):4	 ->Grasp(Right, Needle)
1076 Grasp(Right, Needle):1	Pull(Left, Needle):10	Touch(Right, Needle):4	 ->Grasp(Right, Needle)
1077 Grasp(Right, Needle):1	Pull(Left, Needle):10	Touch(Right, Needle):4	 ->Grasp(Right, Needle)
1078 Grasp(Right, Needle):1	Pull(Left, Needle):10	Touch(Right, Needle):4	 ->Grasp(Right, Needle)
1079 Grasp(Right, Needle):1	Pull(Left, Needle):10	Touch(Right, Needle):4	 ->Grasp(Right, Needle)
1080 Grasp(Right, Needle):1	Pull(Left, Needle):10	Touch(Right, Needle):4	 ->Grasp(Right, Needle)
1081 Grasp(Right, Needle):1	Pull(Left, Needle):10	Touch(Right, Needle):4	 ->Grasp(Right, Needle)
1082 Grasp(Right, Needle):1	Pull(Left, Needle):10	Touch(Right, Needle):4	 ->Grasp(Right, Needle)
1083 Grasp(Right, Needle):1	Pull(Left, Needle):10	Touch(Right, Needle):4	 ->Grasp(Right, Needle)
1084 Grasp(Right, Needle):1	Pull(Left, Needle):10	Touch(Right, Needle):4	 ->Grasp(Right, Needle)
1085 Grasp(Right, Needle):1	Pull(Left, Needle):10	Touch(Right, Needle):4	 ->Grasp(Right, Needle)
1086 Grasp(Right, Needle):1	Pull(Left, Needle):10	Touch(Right, Needle):4	 ->Grasp(Right, Needle)
1087 Grasp(Right, Needle):1	Pull(Left, Needle):10	Touch(Right, Needle):4	 ->Grasp(Right, Needle)
1088 Grasp(Right, Needle):1	Pull(Left, Needle):10	Touch(Right, Needle):4	 ->Grasp(Right, Needle)
1089 Grasp(Right, Needle):1	Pull(Left, Needle):10	Touch(Right, Needle):4	 ->Grasp(Right, Needle)
1090 Grasp(Right, Needle):1	Pull(Left, Needle):10	Touch(Right, Needle):4	 ->Grasp(Right, Needle)
1091 Grasp(Right, Needle):1	Pull(Left, Needle):10	Touch(Right, Needle):4	 ->Grasp(Right, Needle)
1092 Grasp(Right, Needle):1	Pull(Left, Needle):10	Touch(Right, Needle):4	 ->Grasp(Right, Needle)
1093 Grasp(Right, Needle):1	Pull(Left, Needle):10	Grasp(Right, Needle):1	 ->Grasp(Right, Needle)
1094 Grasp(Right, Needle):1	Pull(Left, Needle):10	Grasp(Right, Needle):1	 ->Grasp(Right, Needle)
1095 Grasp(Right, Needle):1	Pull(Left, Needle):10	Grasp(Right, Needle):1	 ->Grasp(Right, Needle)
1096 Grasp(Right, Needle):1	Pull(Left, Needle):10	Grasp(Right, Needle):1	 ->Grasp(Right, Needle)
1097 Grasp(Right, Needle):1	Pull(Left, Needle):10	Grasp(Right, Needle):1	 ->Grasp(Right, Needle)
1098 Grasp(Right, Needle):1	Pull(Left, Needle):10	Grasp(Right, Needle):1	 ->Grasp(Right, Needle)
1099 Grasp(Right, Needle):1	Grasp(Right, Needle):1	Grasp(Right, Needle):1	 ->Grasp(Right, Needle)
1100 Grasp(Right, Needle):1	Grasp(Right, Needle):1	Grasp(Right, Needle):1	 ->Grasp(Right, Needle)
1101 Grasp(Right, Needle):1	Grasp(Right, Needle):1	Grasp(Right, Needle):1	 ->Grasp(Right, Needle)
1102 Grasp(Right, Needle):1	Grasp(Right, Needle):1	Grasp(Right, Needle):1	 ->Grasp(Right, Needle)
1103 Grasp(Right, Needle):1	Grasp(Right, Needle):1	Grasp(Right, Needle):1	 ->Grasp(Right, Needle)
1104 Grasp(Right, Needle):1	Grasp(Right, Needle):1	Grasp(Right, Needle):1	 ->Grasp(Right, Needle)
1105 Grasp(Right, Needle):1	Grasp(Right, Needle):1	Grasp(Right, Needle):1	 ->Grasp(Right, Needle)
1106 Grasp(Right, Needle):1	Grasp(Right, Needle):1	Release(Left, Needle):5	 ->Grasp(Right, Needle)
1107 Grasp(Right, Needle):1	Grasp(Right, Needle):1	Release(Left, Needle):5	 ->Grasp(Right, Needle)
1108 Grasp(Right, Needle):1	Grasp(Right, Needle):1	Release(Left, Needle):5	 ->Grasp(Right, Needle)
1109 Grasp(Right, Needle):1	Grasp(Right, Needle):1	Release(Left, Needle):5	 ->Grasp(Right, Needle)
1110 Grasp(Right, Needle):1	Grasp(Right, Needle):1	Release(Left, Needle):5	 ->Grasp(Right, Needle)
1111 Grasp(Right, Needle):1	Grasp(Right, Needle):1	Release(Left, Needle):5	 ->Grasp(Right, Needle)
1112 Grasp(Right, Needle):1	Grasp(Right, Needle):1	Release(Left, Needle):5	 ->Grasp(Right, Needle)
1113 Grasp(Right, Needle):1	Grasp(Right, Needle):1	Release(Left, Needle):5	 ->Grasp(Right, Needle)
1114 Grasp(Right, Needle):1	Grasp(Right, Needle):1	Release(Left, Needle):5	 ->Grasp(Right, Needle)
1115 Grasp(Right, Needle):1	Release(Left, Needle):5	Release(Left, Needle):5	 ->Release(Left, Needle)
1116 Grasp(Right, Needle):1	Release(Left, Needle):5	Release(Left, Needle):5	 ->Release(Left, Needle)
1117 Grasp(Right, Needle):1	Release(Left, Needle):5	Release(Left, Needle):5	 ->Release(Left, Needle)
1118 Grasp(Right, Needle):1	Release(Left, Needle):5	Untouch(Left, Needle):6	 ->Grasp(Right, Needle)
1119 Grasp(Right, Needle):1	Release(Left, Needle):5	Untouch(Left, Needle):6	 ->Grasp(Right, Needle)
1120 Grasp(Right, Needle):1	Release(Left, Needle):5	Untouch(Left, Needle):6	 ->Grasp(Right, Needle)
1121 Grasp(Right, Needle):1	Release(Left, Needle):5	Untouch(Left, Needle):6	 ->Grasp(Right, Needle)
1122 Grasp(Right, Needle):1	Release(Left, Needle):5	Untouch(Left, Needle):6	 ->Grasp(Right, Needle)
1123 Grasp(Right, Needle):1	Release(Left, Needle):5	Untouch(Left, Needle):6	 ->Grasp(Right, Needle)
1124 Grasp(Right, Needle):1	Release(Left, Needle):5	Untouch(Left, Needle):6	 ->Grasp(Right, Needle)
1125 Grasp(Right, Needle):1	Release(Left, Needle):5	Push(Right, Needle):7	 ->Grasp(Right, Needle)
1126 Grasp(Right, Needle):1	Release(Left, Needle):5	Push(Right, Needle):7	 ->Grasp(Right, Needle)
1127 Grasp(Right, Needle):1	Release(Left, Needle):5	Push(Right, Needle):7	 ->Grasp(Right, Needle)
1128 Grasp(Right, Needle):1	Release(Left, Needle):5	Push(Right, Needle):7	 ->Grasp(Right, Needle)
1129 Grasp(Right, Needle):1	Release(Left, Needle):5	Push(Right, Needle):7	 ->Grasp(Right, Needle)
1130 Grasp(Right, Needle):1	Release(Left, Needle):5	Push(Right, Needle):7	 ->Grasp(Right, Needle)
1131 Push(Right, Needle):7	Release(Left, Needle):5	Push(Right, Needle):7	 ->Push(Right, Needle)
1132 Push(Right, Needle):7	Release(Left, Needle):5	Push(Right, Needle):7	 ->Push(Right, Needle)
1133 Push(Right, Needle):7	Release(Left, Needle):5	Push(Right, Needle):7	 ->Push(Right, Needle)
1134 Push(Right, Needle):7	Release(Left, Needle):5	Push(Right, Needle):7	 ->Push(Right, Needle)
1135 Push(Right, Needle):7	Release(Left, Needle):5	Push(Right, Needle):7	 ->Push(Right, Needle)
1136 Push(Right, Needle):7	Release(Left, Needle):5	Push(Right, Needle):7	 ->Push(Right, Needle)
1137 Push(Right, Needle):7	Release(Left, Needle):5	Push(Right, Needle):7	 ->Push(Right, Needle)
1138 Push(Right, Needle):7	Release(Left, Needle):5	Push(Right, Needle):7	 ->Push(Right, Needle)
1139 Push(Right, Needle):7	Release(Left, Needle):5	Push(Right, Needle):7	 ->Push(Right, Needle)
1140 Push(Right, Needle):7	Release(Left, Needle):5	Push(Right, Needle):7	 ->Push(Right, Needle)
1141 Push(Right, Needle):7	Release(Left, Needle):5	Push(Right, Needle):7	 ->Push(Right, Needle)
1142 Push(Right, Needle):7	Release(Left, Needle):5	Push(Right, Needle):7	 ->Push(Right, Needle)
1143 Push(Right, Needle):7	Release(Left, Needle):5	Push(Right, Needle):7	 ->Push(Right, Needle)
1144 Push(Right, Needle):7	Release(Left, Needle):5	Push(Right, Needle):7	 ->Push(Right, Needle)
1145 Push(Right, Needle):7	Release(Left, Needle):5	Push(Right, Needle):7	 ->Push(Right, Needle)
1146 Push(Right, Needle):7	Release(Left, Needle):5	Push(Right, Needle):7	 ->Push(Right, Needle)
1147 Push(Right, Needle):7	Release(Left, Needle):5	Push(Right, Needle):7	 ->Push(Right, Needle)
1148 Push(Right, Needle):7	Release(Left, Needle):5	Push(Right, Needle):7	 ->Push(Right, Needle)
1149 Push(Right, Needle):7	Release(Left, Needle):5	Push(Right, Needle):7	 ->Push(Right, Needle)
1150 Push(Right, Needle):7	Release(Left, Needle):5	Push(Right, Needle):7	 ->Push(Right, Needle)
1151 Push(Right, Needle):7	Release(Left, Needle):5	Push(Right, Needle):7	 ->Push(Right, Needle)
1152 Push(Right, Needle):7	Release(Left, Needle):5	Push(Right, Needle):7	 ->Push(Right, Needle)
1153 Push(Right, Needle):7	Release(Left, Needle):5	Push(Right, Needle):7	 ->Push(Right, Needle)
1154 Push(Right, Needle):7	Release(Left, Needle):5	Push(Right, Needle):7	 ->Push(Right, Needle)
1155 Push(Right, Needle):7	Release(Left, Needle):5	Push(Right, Needle):7	 ->Push(Right, Needle)
1156 Push(Right, Needle):7	Release(Left, Needle):5	Push(Right, Needle):7	 ->Push(Right, Needle)
1157 Push(Right, Needle):7	Release(Left, Needle):5	Push(Right, Needle):7	 ->Push(Right, Needle)
1158 Push(Right, Needle):7	Release(Left, Needle):5	Push(Right, Needle):7	 ->Push(Right, Needle)
1159 Push(Right, Needle):7	Release(Left, Needle):5	Push(Right, Needle):7	 ->Push(Right, Needle)
1160 Push(Right, Needle):7	Release(Left, Needle):5	Push(Right, Needle):7	 ->Push(Right, Needle)
1161 Push(Right, Needle):7	Release(Left, Needle):5	Push(Right, Needle):7	 ->Push(Right, Needle)
1162 Push(Right, Needle):7	Release(Left, Needle):5	Push(Right, Needle):7	 ->Push(Right, Needle)
1163 Push(Right, Needle):7	Release(Left, Needle):5	Push(Right, Needle):7	 ->Push(Right, Needle)
1164 Push(Right, Needle):7	Release(Left, Needle):5	Push(Right, Needle):7	 ->Push(Right, Needle)
1165 Push(Right, Needle):7	Release(Left, Needle):5	Push(Right, Needle):7	 ->Push(Right, Needle)
1166 Push(Right, Needle):7	Release(Left, Needle):5	Push(Right, Needle):7	 ->Push(Right, Needle)
1167 Push(Right, Needle):7	Release(Left, Needle):5	Push(Right, Needle):7	 ->Push(Right, Needle)
1168 Push(Right, Needle):7	Release(Left, Needle):5	Push(Right, Needle):7	 ->Push(Right, Needle)
1169 Push(Right, Needle):7	Release(Left, Needle):5	Push(Right, Needle):7	 ->Push(Right, Needle)
1170 Push(Right, Needle):7	Release(Left, Needle):5	Push(Right, Needle):7	 ->Push(Right, Needle)
1171 Push(Right, Needle):7	Release(Left, Needle):5	Push(Right, Needle):7	 ->Push(Right, Needle)
1172 Push(Right, Needle):7	Release(Left, Needle):5	Push(Right, Needle):7	 ->Push(Right, Needle)
1173 Push(Right, Needle):7	Release(Left, Needle):5	Push(Right, Needle):7	 ->Push(Right, Needle)
1174 Push(Right, Needle):7	Release(Left, Needle):5	Push(Right, Needle):7	 ->Push(Right, Needle)
1175 Push(Right, Needle):7	Release(Left, Needle):5	Push(Right, Needle):7	 ->Push(Right, Needle)
1176 Push(Right, Needle):7	Release(Left, Needle):5	Push(Right, Needle):7	 ->Push(Right, Needle)
1177 Push(Right, Needle):7	Release(Left, Needle):5	Push(Right, Needle):7	 ->Push(Right, Needle)
1178 Push(Right, Needle):7	Release(Left, Needle):5	Push(Right, Needle):7	 ->Push(Right, Needle)
1179 Push(Right, Needle):7	Release(Left, Needle):5	Push(Right, Needle):7	 ->Push(Right, Needle)
1180 Push(Right, Needle):7	Release(Left, Needle):5	Push(Right, Needle):7	 ->Push(Right, Needle)
1181 Push(Right, Needle):7	Release(Left, Needle):5	Push(Right, Needle):7	 ->Push(Right, Needle)
1182 Push(Right, Needle):7	Release(Left, Needle):5	Push(Right, Needle):7	 ->Push(Right, Needle)
1183 Push(Right, Needle):7	Release(Left, Needle):5	Push(Right, Needle):7	 ->Push(Right, Needle)
1184 Push(Right, Needle):7	Release(Left, Needle):5	Push(Right, Needle):7	 ->Push(Right, Needle)
1185 Push(Right, Needle):7	Release(Left, Needle):5	Push(Right, Needle):7	 ->Push(Right, Needle)
1186 Push(Right, Needle):7	Release(Left, Needle):5	Push(Right, Needle):7	 ->Push(Right, Needle)
1187 Push(Right, Needle):7	Release(Left, Needle):5	Push(Right, Needle):7	 ->Push(Right, Needle)
1188 Push(Right, Needle):7	Release(Left, Needle):5	Push(Right, Needle):7	 ->Push(Right, Needle)
1189 Push(Right, Needle):7	Release(Left, Needle):5	Push(Right, Needle):7	 ->Push(Right, Needle)
1190 Push(Right, Needle):7	Release(Left, Needle):5	Push(Right, Needle):7	 ->Push(Right, Needle)
1191 Push(Right, Needle):7	Release(Left, Needle):5	Push(Right, Needle):7	 ->Push(Right, Needle)
1192 Push(Right, Needle):7	Release(Left, Needle):5	Push(Right, Needle):7	 ->Push(Right, Needle)
1193 Push(Right, Needle):7	Release(Left, Needle):5	Push(Right, Needle):7	 ->Push(Right, Needle)
1194 Push(Right, Needle):7	Release(Left, Needle):5	Push(Right, Needle):7	 ->Push(Right, Needle)
1195 Push(Right, Needle):7	Release(Left, Needle):5	Push(Right, Needle):7	 ->Push(Right, Needle)
1196 Push(Right, Needle):7	Release(Left, Needle):5	Push(Right, Needle):7	 ->Push(Right, Needle)
1197 Push(Right, Needle):7	Release(Left, Needle):5	Push(Right, Needle):7	 ->Push(Right, Needle)
1198 Push(Right, Needle):7	Release(Left, Needle):5	Push(Right, Needle):7	 ->Push(Right, Needle)
1199 Push(Right, Needle):7	Release(Left, Needle):5	Push(Right, Needle):7	 ->Push(Right, Needle)
1200 Push(Right, Needle):7	Release(Left, Needle):5	Push(Right, Needle):7	 ->Push(Right, Needle)
1201 Push(Right, Needle):7	Release(Left, Needle):5	Push(Right, Needle):7	 ->Push(Right, Needle)
1202 Push(Right, Needle):7	Release(Left, Needle):5	Push(Right, Needle):7	 ->Push(Right, Needle)
1203 Push(Right, Needle):7	Release(Left, Needle):5	Push(Right, Needle):7	 ->Push(Right, Needle)
1204 Push(Right, Needle):7	Release(Left, Needle):5	Push(Right, Needle):7	 ->Push(Right, Needle)
1205 Push(Right, Needle):7	Release(Left, Needle):5	Push(Right, Needle):7	 ->Push(Right, Needle)
1206 Push(Right, Needle):7	Release(Left, Needle):5	Push(Right, Needle):7	 ->Push(Right, Needle)
1207 Push(Right, Needle):7	Release(Left, Needle):5	Push(Right, Needle):7	 ->Push(Right, Needle)
1208 Push(Right, Needle):7	Touch(Needle, Fabric/Tissue):8	Push(Right, Needle):7	 ->Push(Right, Needle)
1209 Push(Right, Needle):7	Touch(Needle, Fabric/Tissue):8	Push(Right, Needle):7	 ->Push(Right, Needle)
1210 Push(Right, Needle):7	Touch(Needle, Fabric/Tissue):8	Push(Right, Needle):7	 ->Push(Right, Needle)
1211 Push(Right, Needle):7	Touch(Needle, Fabric/Tissue):8	Push(Right, Needle):7	 ->Push(Right, Needle)
1212 Push(Right, Needle):7	Touch(Needle, Fabric/Tissue):8	Push(Right, Needle):7	 ->Push(Right, Needle)
1213 Push(Right, Needle):7	Touch(Needle, Fabric/Tissue):8	Push(Right, Needle):7	 ->Push(Right, Needle)
1214 Push(Right, Needle):7	Touch(Needle, Fabric/Tissue):8	Push(Right, Needle):7	 ->Push(Right, Needle)
1215 Push(Right, Needle):7	Touch(Needle, Fabric/Tissue):8	Push(Right, Needle):7	 ->Push(Right, Needle)
1216 Push(Right, Needle):7	Touch(Needle, Fabric/Tissue):8	Push(Right, Needle):7	 ->Push(Right, Needle)
1217 Push(Right, Needle):7	Touch(Needle, Fabric/Tissue):8	Push(Right, Needle):7	 ->Push(Right, Needle)
1218 Push(Right, Needle):7	Touch(Needle, Fabric/Tissue):8	Push(Right, Needle):7	 ->Push(Right, Needle)
1219 Push(Right, Needle):7	Touch(Needle, Fabric/Tissue):8	Push(Right, Needle):7	 ->Push(Right, Needle)
1220 Push(Right, Needle):7	Touch(Needle, Fabric/Tissue):8	Push(Right, Needle):7	 ->Push(Right, Needle)
1221 Push(Right, Needle):7	Touch(Needle, Fabric/Tissue):8	Push(Right, Needle):7	 ->Push(Right, Needle)
1222 Push(Right, Needle):7	Touch(Needle, Fabric/Tissue):8	Push(Right, Needle):7	 ->Push(Right, Needle)
1223 Push(Right, Needle):7	Touch(Needle, Fabric/Tissue):8	Push(Right, Needle):7	 ->Push(Right, Needle)
1224 Push(Right, Needle):7	Touch(Needle, Fabric/Tissue):8	Push(Right, Needle):7	 ->Push(Right, Needle)
1225 Push(Right, Needle):7	Touch(Needle, Fabric/Tissue):8	Push(Right, Needle):7	 ->Push(Right, Needle)
1226 Push(Right, Needle):7	Touch(Needle, Fabric/Tissue):8	Push(Right, Needle):7	 ->Push(Right, Needle)
1227 Push(Right, Needle):7	Touch(Needle, Fabric/Tissue):8	Push(Right, Needle):7	 ->Push(Right, Needle)
1228 Push(Right, Needle):7	Touch(Needle, Fabric/Tissue):8	Push(Right, Needle):7	 ->Push(Right, Needle)
1229 Push(Right, Needle):7	Touch(Needle, Fabric/Tissue):8	Push(Right, Needle):7	 ->Push(Right, Needle)
1230 Push(Right, Needle):7	Touch(Needle, Fabric/Tissue):8	Push(Right, Needle):7	 ->Push(Right, Needle)
1231 Push(Right, Needle):7	Touch(Needle, Fabric/Tissue):8	Push(Right, Needle):7	 ->Push(Right, Needle)
1232 Push(Right, Needle):7	Touch(Needle, Fabric/Tissue):8	Push(Right, Needle):7	 ->Push(Right, Needle)
1233 Push(Right, Needle):7	Touch(Needle, Fabric/Tissue):8	Push(Right, Needle):7	 ->Push(Right, Needle)
1234 Push(Right, Needle):7	Touch(Needle, Fabric/Tissue):8	Push(Right, Needle):7	 ->Push(Right, Needle)
1235 Push(Right, Needle):7	Touch(Needle, Fabric/Tissue):8	Push(Right, Needle):7	 ->Push(Right, Needle)
1236 Push(Right, Needle):7	Touch(Needle, Fabric/Tissue):8	Push(Right, Needle):7	 ->Push(Right, Needle)
1237 Push(Right, Needle):7	Touch(Needle, Fabric/Tissue):8	Push(Right, Needle):7	 ->Push(Right, Needle)
1238 Push(Right, Needle):7	Touch(Needle, Fabric/Tissue):8	Push(Right, Needle):7	 ->Push(Right, Needle)
1239 Push(Right, Needle):7	Touch(Needle, Fabric/Tissue):8	Push(Right, Needle):7	 ->Push(Right, Needle)
1240 Push(Right, Needle):7	Touch(Needle, Fabric/Tissue):8	Push(Right, Needle):7	 ->Push(Right, Needle)
1241 Push(Right, Needle):7	Touch(Needle, Fabric/Tissue):8	Push(Right, Needle):7	 ->Push(Right, Needle)
1242 Push(Right, Needle):7	Touch(Needle, Fabric/Tissue):8	Push(Right, Needle):7	 ->Push(Right, Needle)
1243 Push(Right, Needle):7	Touch(Needle, Fabric/Tissue):8	Push(Right, Needle):7	 ->Push(Right, Needle)
1244 Push(Right, Needle):7	Touch(Needle, Fabric/Tissue):8	Push(Right, Needle):7	 ->Push(Right, Needle)
1245 Push(Right, Needle):7	Touch(Needle, Fabric/Tissue):8	Push(Right, Needle):7	 ->Push(Right, Needle)
1246 Push(Right, Needle):7	Touch(Needle, Fabric/Tissue):8	Push(Right, Needle):7	 ->Push(Right, Needle)
1247 Push(Right, Needle):7	Touch(Needle, Fabric/Tissue):8	Push(Right, Needle):7	 ->Push(Right, Needle)
1248 Push(Right, Needle):7	Touch(Needle, Fabric/Tissue):8	Push(Right, Needle):7	 ->Push(Right, Needle)
1249 Push(Right, Needle):7	Touch(Needle, Fabric/Tissue):8	Push(Right, Needle):7	 ->Push(Right, Needle)
1250 Push(Right, Needle):7	Touch(Needle, Fabric/Tissue):8	Push(Right, Needle):7	 ->Push(Right, Needle)
1251 Push(Right, Needle):7	Touch(Needle, Fabric/Tissue):8	Push(Right, Needle):7	 ->Push(Right, Needle)
1252 Push(Right, Needle):7	Push(Right, Needle):7	Push(Right, Needle):7	 ->Push(Right, Needle)
1253 Push(Right, Needle):7	Push(Right, Needle):7	Push(Right, Needle):7	 ->Push(Right, Needle)
1254 Push(Right, Needle):7	Push(Right, Needle):7	Push(Right, Needle):7	 ->Push(Right, Needle)
1255 Push(Right, Needle):7	Push(Right, Needle):7	Push(Right, Needle):7	 ->Push(Right, Needle)
1256 Push(Right, Needle):7	Push(Right, Needle):7	Push(Right, Needle):7	 ->Push(Right, Needle)
1257 Push(Right, Needle):7	Push(Right, Needle):7	Push(Right, Needle):7	 ->Push(Right, Needle)
1258 Push(Right, Needle):7	Push(Right, Needle):7	Push(Right, Needle):7	 ->Push(Right, Needle)
1259 Push(Right, Needle):7	Push(Right, Needle):7	Push(Right, Needle):7	 ->Push(Right, Needle)
1260 Push(Right, Needle):7	Push(Right, Needle):7	Push(Right, Needle):7	 ->Push(Right, Needle)
1261 Push(Right, Needle):7	Push(Right, Needle):7	Push(Right, Needle):7	 ->Push(Right, Needle)
1262 Push(Right, Needle):7	Push(Right, Needle):7	Push(Right, Needle):7	 ->Push(Right, Needle)
1263 Push(Right, Needle):7	Push(Right, Needle):7	Push(Right, Needle):7	 ->Push(Right, Needle)
1264 Push(Right, Needle):7	Push(Right, Needle):7	Push(Right, Needle):7	 ->Push(Right, Needle)
1265 Push(Right, Needle):7	Push(Right, Needle):7	Push(Right, Needle):7	 ->Push(Right, Needle)
1266 Push(Right, Needle):7	Push(Right, Needle):7	Push(Right, Needle):7	 ->Push(Right, Needle)
1267 Push(Right, Needle):7	Push(Right, Needle):7	Push(Right, Needle):7	 ->Push(Right, Needle)
1268 Push(Right, Needle):7	Push(Right, Needle):7	Push(Right, Needle):7	 ->Push(Right, Needle)
1269 Push(Right, Needle):7	Push(Right, Needle):7	Push(Right, Needle):7	 ->Push(Right, Needle)
1270 Push(Right, Needle):7	Push(Right, Needle):7	Push(Right, Needle):7	 ->Push(Right, Needle)
1271 Push(Right, Needle):7	Push(Right, Needle):7	Push(Right, Needle):7	 ->Push(Right, Needle)
1272 Push(Right, Needle):7	Push(Right, Needle):7	Push(Right, Needle):7	 ->Push(Right, Needle)
1273 Push(Right, Needle):7	Push(Right, Needle):7	Push(Right, Needle):7	 ->Push(Right, Needle)
1274 Push(Right, Needle):7	Push(Right, Needle):7	Push(Right, Needle):7	 ->Push(Right, Needle)
1275 Push(Right, Needle):7	Push(Right, Needle):7	Push(Right, Needle):7	 ->Push(Right, Needle)
1276 Push(Right, Needle):7	Push(Right, Needle):7	Push(Right, Needle):7	 ->Push(Right, Needle)
1277 Push(Right, Needle):7	Push(Right, Needle):7	Push(Right, Needle):7	 ->Push(Right, Needle)
1278 Push(Right, Needle):7	Push(Right, Needle):7	Push(Right, Needle):7	 ->Push(Right, Needle)
1279 Push(Right, Needle):7	Push(Right, Needle):7	Push(Right, Needle):7	 ->Push(Right, Needle)
1280 Push(Right, Needle):7	Push(Right, Needle):7	Push(Right, Needle):7	 ->Push(Right, Needle)
1281 Push(Right, Needle):7	Push(Right, Needle):7	Push(Right, Needle):7	 ->Push(Right, Needle)
1282 Push(Right, Needle):7	Push(Right, Needle):7	Push(Right, Needle):7	 ->Push(Right, Needle)
1283 Push(Right, Needle):7	Push(Right, Needle):7	Push(Right, Needle):7	 ->Push(Right, Needle)
1284 Push(Right, Needle):7	Push(Right, Needle):7	Push(Right, Needle):7	 ->Push(Right, Needle)
1285 Push(Right, Needle):7	Push(Right, Needle):7	Push(Right, Needle):7	 ->Push(Right, Needle)
1286 Push(Right, Needle):7	Push(Right, Needle):7	Push(Right, Needle):7	 ->Push(Right, Needle)
1287 Push(Right, Needle):7	Push(Right, Needle):7	Push(Right, Needle):7	 ->Push(Right, Needle)
1288 Push(Right, Needle):7	Push(Right, Needle):7	Push(Right, Needle):7	 ->Push(Right, Needle)
1289 Push(Right, Needle):7	Push(Right, Needle):7	Push(Right, Needle):7	 ->Push(Right, Needle)
1290 Push(Right, Needle):7	Push(Right, Needle):7	Push(Right, Needle):7	 ->Push(Right, Needle)
1291 Push(Right, Needle):7	Push(Right, Needle):7	Push(Right, Needle):7	 ->Push(Right, Needle)
1292 Push(Right, Needle):7	Push(Right, Needle):7	Push(Right, Needle):7	 ->Push(Right, Needle)
1293 Push(Right, Needle):7	Push(Right, Needle):7	Push(Right, Needle):7	 ->Push(Right, Needle)
1294 Push(Right, Needle):7	Push(Right, Needle):7	Push(Right, Needle):7	 ->Push(Right, Needle)
1295 Push(Right, Needle):7	Push(Right, Needle):7	Push(Right, Needle):7	 ->Push(Right, Needle)
1296 Push(Right, Needle):7	Push(Right, Needle):7	Push(Right, Needle):7	 ->Push(Right, Needle)
1297 Push(Right, Needle):7	Push(Right, Needle):7	Push(Right, Needle):7	 ->Push(Right, Needle)
1298 Push(Right, Needle):7	Push(Right, Needle):7	Push(Right, Needle):7	 ->Push(Right, Needle)
1299 Push(Right, Needle):7	Push(Right, Needle):7	Push(Right, Needle):7	 ->Push(Right, Needle)
1300 Push(Right, Needle):7	Push(Right, Needle):7	Push(Right, Needle):7	 ->Push(Right, Needle)
1301 Push(Right, Needle):7	Push(Right, Needle):7	Push(Right, Needle):7	 ->Push(Right, Needle)
1302 Push(Right, Needle):7	Push(Right, Needle):7	Push(Right, Needle):7	 ->Push(Right, Needle)
1303 Push(Right, Needle):7	Push(Right, Needle):7	Push(Right, Needle):7	 ->Push(Right, Needle)
1304 Push(Right, Needle):7	Push(Right, Needle):7	Push(Right, Needle):7	 ->Push(Right, Needle)
1305 Push(Right, Needle):7	Push(Right, Needle):7	Push(Right, Needle):7	 ->Push(Right, Needle)
1306 Push(Right, Needle):7	Push(Right, Needle):7	Push(Right, Needle):7	 ->Push(Right, Needle)
1307 Push(Right, Needle):7	Push(Right, Needle):7	Push(Right, Needle):7	 ->Push(Right, Needle)
1308 Push(Right, Needle):7	Push(Right, Needle):7	Push(Right, Needle):7	 ->Push(Right, Needle)
1309 Push(Right, Needle):7	Push(Right, Needle):7	Push(Right, Needle):7	 ->Push(Right, Needle)
1310 Push(Right, Needle):7	Push(Right, Needle):7	Push(Right, Needle):7	 ->Push(Right, Needle)
1311 Push(Right, Needle):7	Push(Right, Needle):7	Push(Right, Needle):7	 ->Push(Right, Needle)
1312 Push(Right, Needle):7	Push(Right, Needle):7	Push(Right, Needle):7	 ->Push(Right, Needle)
1313 Push(Right, Needle):7	Push(Right, Needle):7	Push(Right, Needle):7	 ->Push(Right, Needle)
1314 Push(Right, Needle):7	Push(Right, Needle):7	Push(Right, Needle):7	 ->Push(Right, Needle)
1315 Push(Right, Needle):7	Push(Right, Needle):7	Push(Right, Needle):7	 ->Push(Right, Needle)
1316 Push(Right, Needle):7	Push(Right, Needle):7	Push(Right, Needle):7	 ->Push(Right, Needle)
1317 Push(Right, Needle):7	Push(Right, Needle):7	Push(Right, Needle):7	 ->Push(Right, Needle)
1318 Push(Right, Needle):7	Push(Right, Needle):7	Push(Right, Needle):7	 ->Push(Right, Needle)
1319 Push(Right, Needle):7	Push(Right, Needle):7	Push(Right, Needle):7	 ->Push(Right, Needle)
1320 Push(Right, Needle):7	Push(Right, Needle):7	Push(Right, Needle):7	 ->Push(Right, Needle)
1321 Push(Right, Needle):7	Push(Right, Needle):7	Push(Right, Needle):7	 ->Push(Right, Needle)
1322 Push(Right, Needle):7	Push(Right, Needle):7	Push(Right, Needle):7	 ->Push(Right, Needle)
1323 Push(Right, Needle):7	Push(Right, Needle):7	Push(Right, Needle):7	 ->Push(Right, Needle)
1324 Push(Right, Needle):7	Push(Right, Needle):7	Push(Right, Needle):7	 ->Push(Right, Needle)
1325 Push(Right, Needle):7	Push(Right, Needle):7	Push(Right, Needle):7	 ->Push(Right, Needle)
1326 Push(Right, Needle):7	Push(Right, Needle):7	Push(Right, Needle):7	 ->Push(Right, Needle)
1327 Push(Right, Needle):7	Push(Right, Needle):7	Push(Right, Needle):7	 ->Push(Right, Needle)
1328 Push(Right, Needle):7	Push(Right, Needle):7	Push(Right, Needle):7	 ->Push(Right, Needle)
1329 Push(Right, Needle):7	Push(Right, Needle):7	Push(Right, Needle):7	 ->Push(Right, Needle)
1330 Push(Right, Needle):7	Push(Right, Needle):7	Push(Right, Needle):7	 ->Push(Right, Needle)
1331 Push(Right, Needle):7	Push(Right, Needle):7	Push(Right, Needle):7	 ->Push(Right, Needle)
1332 Push(Right, Needle):7	Push(Right, Needle):7	Push(Right, Needle):7	 ->Push(Right, Needle)
1333 Push(Right, Needle):7	Push(Right, Needle):7	Push(Right, Needle):7	 ->Push(Right, Needle)
1334 Push(Right, Needle):7	Push(Right, Needle):7	Push(Right, Needle):7	 ->Push(Right, Needle)
1335 Push(Right, Needle):7	Push(Right, Needle):7	Push(Right, Needle):7	 ->Push(Right, Needle)
1336 Push(Right, Needle):7	Push(Right, Needle):7	Push(Right, Needle):7	 ->Push(Right, Needle)
1337 Push(Right, Needle):7	Push(Right, Needle):7	Push(Right, Needle):7	 ->Push(Right, Needle)
1338 Push(Right, Needle):7	Push(Right, Needle):7	Push(Right, Needle):7	 ->Push(Right, Needle)
1339 Push(Right, Needle):7	Push(Right, Needle):7	Push(Right, Needle):7	 ->Push(Right, Needle)
1340 Push(Right, Needle):7	Push(Right, Needle):7	Push(Right, Needle):7	 ->Push(Right, Needle)
1341 Push(Right, Needle):7	Push(Right, Needle):7	Push(Right, Needle):7	 ->Push(Right, Needle)
1342 Push(Right, Needle):7	Push(Right, Needle):7	Push(Right, Needle):7	 ->Push(Right, Needle)
1343 Push(Right, Needle):7	Push(Right, Needle):7	Push(Right, Needle):7	 ->Push(Right, Needle)
1344 Push(Right, Needle):7	Push(Right, Needle):7	Push(Right, Needle):7	 ->Push(Right, Needle)
1345 Push(Right, Needle):7	Push(Right, Needle):7	Push(Right, Needle):7	 ->Push(Right, Needle)
1346 Push(Right, Needle):7	Push(Right, Needle):7	Push(Right, Needle):7	 ->Push(Right, Needle)
1347 Push(Right, Needle):7	Push(Right, Needle):7	Push(Right, Needle):7	 ->Push(Right, Needle)
1348 Push(Right, Needle):7	Push(Right, Needle):7	Push(Right, Needle):7	 ->Push(Right, Needle)
1349 Push(Right, Needle):7	Push(Right, Needle):7	Push(Right, Needle):7	 ->Push(Right, Needle)
1350 Push(Right, Needle):7	Push(Right, Needle):7	Push(Right, Needle):7	 ->Push(Right, Needle)
1351 Push(Right, Needle):7	Push(Right, Needle):7	Push(Right, Needle):7	 ->Push(Right, Needle)
1352 Push(Right, Needle):7	Push(Right, Needle):7	Push(Right, Needle):7	 ->Push(Right, Needle)
1353 Push(Right, Needle):7	Push(Right, Needle):7	Push(Right, Needle):7	 ->Push(Right, Needle)
1354 Push(Right, Needle):7	Push(Right, Needle):7	Push(Right, Needle):7	 ->Push(Right, Needle)
1355 Push(Right, Needle):7	Push(Right, Needle):7	Push(Right, Needle):7	 ->Push(Right, Needle)
1356 Grasp(Left, Needle):0	Push(Right, Needle):7	Touch(Left, Needle):9	 ->Grasp(Left, Needle)
1357 Grasp(Left, Needle):0	Push(Right, Needle):7	Touch(Left, Needle):9	 ->Grasp(Left, Needle)
1358 Grasp(Left, Needle):0	Push(Right, Needle):7	Touch(Left, Needle):9	 ->Grasp(Left, Needle)
1359 Grasp(Left, Needle):0	Push(Right, Needle):7	Touch(Left, Needle):9	 ->Grasp(Left, Needle)
1360 Grasp(Left, Needle):0	Push(Right, Needle):7	Touch(Left, Needle):9	 ->Grasp(Left, Needle)
1361 Grasp(Left, Needle):0	Push(Right, Needle):7	Touch(Left, Needle):9	 ->Grasp(Left, Needle)
1362 Grasp(Left, Needle):0	Push(Right, Needle):7	Touch(Left, Needle):9	 ->Grasp(Left, Needle)
1363 Grasp(Left, Needle):0	Push(Right, Needle):7	Touch(Left, Needle):9	 ->Grasp(Left, Needle)
1364 Grasp(Left, Needle):0	Push(Right, Needle):7	Touch(Left, Needle):9	 ->Grasp(Left, Needle)
1365 Grasp(Left, Needle):0	Push(Right, Needle):7	Touch(Left, Needle):9	 ->Grasp(Left, Needle)
1366 Grasp(Left, Needle):0	Push(Right, Needle):7	Touch(Left, Needle):9	 ->Grasp(Left, Needle)
1367 Grasp(Left, Needle):0	Push(Right, Needle):7	Touch(Left, Needle):9	 ->Grasp(Left, Needle)
1368 Grasp(Left, Needle):0	Push(Right, Needle):7	Touch(Left, Needle):9	 ->Grasp(Left, Needle)
1369 Grasp(Left, Needle):0	Push(Right, Needle):7	Touch(Left, Needle):9	 ->Grasp(Left, Needle)
1370 Grasp(Left, Needle):0	Push(Right, Needle):7	Touch(Left, Needle):9	 ->Grasp(Left, Needle)
1371 Grasp(Left, Needle):0	Push(Right, Needle):7	Touch(Left, Needle):9	 ->Grasp(Left, Needle)
1372 Grasp(Left, Needle):0	Push(Right, Needle):7	Touch(Left, Needle):9	 ->Grasp(Left, Needle)
1373 Grasp(Left, Needle):0	Push(Right, Needle):7	Touch(Left, Needle):9	 ->Grasp(Left, Needle)
1374 Grasp(Left, Needle):0	Push(Right, Needle):7	Touch(Left, Needle):9	 ->Grasp(Left, Needle)
1375 Grasp(Left, Needle):0	Push(Right, Needle):7	Touch(Left, Needle):9	 ->Grasp(Left, Needle)
1376 Grasp(Left, Needle):0	Push(Right, Needle):7	Touch(Left, Needle):9	 ->Grasp(Left, Needle)
1377 Grasp(Left, Needle):0	Push(Right, Needle):7	Touch(Left, Needle):9	 ->Grasp(Left, Needle)
1378 Grasp(Left, Needle):0	Push(Right, Needle):7	Touch(Left, Needle):9	 ->Grasp(Left, Needle)
1379 Grasp(Left, Needle):0	Push(Right, Needle):7	Touch(Left, Needle):9	 ->Grasp(Left, Needle)
1380 Grasp(Left, Needle):0	Push(Right, Needle):7	Touch(Left, Needle):9	 ->Grasp(Left, Needle)
1381 Grasp(Left, Needle):0	Push(Right, Needle):7	Touch(Left, Needle):9	 ->Grasp(Left, Needle)
1382 Grasp(Left, Needle):0	Push(Right, Needle):7	Touch(Left, Needle):9	 ->Grasp(Left, Needle)
1383 Grasp(Left, Needle):0	Push(Right, Needle):7	Touch(Left, Needle):9	 ->Grasp(Left, Needle)
1384 Grasp(Left, Needle):0	Push(Right, Needle):7	Touch(Left, Needle):9	 ->Grasp(Left, Needle)
1385 Grasp(Left, Needle):0	Push(Right, Needle):7	Touch(Left, Needle):9	 ->Grasp(Left, Needle)
1386 Grasp(Left, Needle):0	Push(Right, Needle):7	Touch(Left, Needle):9	 ->Grasp(Left, Needle)
1387 Grasp(Left, Needle):0	Push(Right, Needle):7	Touch(Left, Needle):9	 ->Grasp(Left, Needle)
1388 Grasp(Left, Needle):0	Push(Right, Needle):7	Touch(Left, Needle):9	 ->Grasp(Left, Needle)
1389 Grasp(Left, Needle):0	Push(Right, Needle):7	Touch(Left, Needle):9	 ->Grasp(Left, Needle)
1390 Grasp(Left, Needle):0	Push(Right, Needle):7	Touch(Left, Needle):9	 ->Grasp(Left, Needle)
1391 Grasp(Left, Needle):0	Push(Right, Needle):7	Grasp(Left, Needle):0	 ->Grasp(Left, Needle)
1392 Grasp(Left, Needle):0	Push(Right, Needle):7	Grasp(Left, Needle):0	 ->Grasp(Left, Needle)
1393 Grasp(Left, Needle):0	Push(Right, Needle):7	Grasp(Left, Needle):0	 ->Grasp(Left, Needle)
1394 Grasp(Left, Needle):0	Push(Right, Needle):7	Grasp(Left, Needle):0	 ->Grasp(Left, Needle)
1395 Grasp(Left, Needle):0	Push(Right, Needle):7	Grasp(Left, Needle):0	 ->Grasp(Left, Needle)
1396 Grasp(Left, Needle):0	Push(Right, Needle):7	Grasp(Left, Needle):0	 ->Grasp(Left, Needle)
1397 Grasp(Left, Needle):0	Push(Right, Needle):7	Grasp(Left, Needle):0	 ->Grasp(Left, Needle)
1398 Grasp(Left, Needle):0	Push(Right, Needle):7	Grasp(Left, Needle):0	 ->Grasp(Left, Needle)
1399 Grasp(Left, Needle):0	Push(Right, Needle):7	Grasp(Left, Needle):0	 ->Grasp(Left, Needle)
1400 Grasp(Left, Needle):0	Push(Right, Needle):7	Grasp(Left, Needle):0	 ->Grasp(Left, Needle)
1401 Grasp(Left, Needle):0	Push(Right, Needle):7	Grasp(Left, Needle):0	 ->Grasp(Left, Needle)
1402 Grasp(Left, Needle):0	Push(Right, Needle):7	Grasp(Left, Needle):0	 ->Grasp(Left, Needle)
1403 Grasp(Left, Needle):0	Push(Right, Needle):7	Grasp(Left, Needle):0	 ->Grasp(Left, Needle)
1404 Grasp(Left, Needle):0	Push(Right, Needle):7	Grasp(Left, Needle):0	 ->Grasp(Left, Needle)
1405 Grasp(Left, Needle):0	Push(Right, Needle):7	Grasp(Left, Needle):0	 ->Grasp(Left, Needle)
1406 Grasp(Left, Needle):0	Push(Right, Needle):7	Grasp(Left, Needle):0	 ->Grasp(Left, Needle)
1407 Grasp(Left, Needle):0	Push(Right, Needle):7	Release(Right, Needle):2	 ->Grasp(Left, Needle)
1408 Grasp(Left, Needle):0	Grasp(Left, Needle):0	Release(Right, Needle):2	 ->Grasp(Left, Needle)
1409 Grasp(Left, Needle):0	Grasp(Left, Needle):0	Release(Right, Needle):2	 ->Grasp(Left, Needle)
1410 Grasp(Left, Needle):0	Grasp(Left, Needle):0	Release(Right, Needle):2	 ->Grasp(Left, Needle)
1411 Grasp(Left, Needle):0	Grasp(Left, Needle):0	Release(Right, Needle):2	 ->Grasp(Left, Needle)
1412 Grasp(Left, Needle):0	Release(Right, Needle):2	Release(Right, Needle):2	 ->Release(Right, Needle)
1413 Grasp(Left, Needle):0	Release(Right, Needle):2	Pull(Left, Needle):10	 ->Grasp(Left, Needle)
1414 Grasp(Left, Needle):0	Release(Right, Needle):2	Pull(Left, Needle):10	 ->Grasp(Left, Needle)
1415 Grasp(Left, Needle):0	Release(Right, Needle):2	Pull(Left, Needle):10	 ->Grasp(Left, Needle)
1416 Grasp(Left, Needle):0	Release(Right, Needle):2	Pull(Left, Needle):10	 ->Grasp(Left, Needle)
1417 Grasp(Left, Needle):0	Release(Right, Needle):2	Pull(Left, Needle):10	 ->Grasp(Left, Needle)
1418 Grasp(Left, Needle):0	Pull(Left, Needle):10	Pull(Left, Needle):10	 ->Pull(Left, Needle)
1419 Grasp(Left, Needle):0	Pull(Left, Needle):10	Pull(Left, Needle):10	 ->Pull(Left, Needle)
1420 Grasp(Left, Needle):0	Pull(Left, Needle):10	Pull(Left, Needle):10	 ->Pull(Left, Needle)
1421 Grasp(Left, Needle):0	Pull(Left, Needle):10	Pull(Left, Needle):10	 ->Pull(Left, Needle)
1422 Grasp(Left, Needle):0	Pull(Left, Needle):10	Pull(Left, Needle):10	 ->Pull(Left, Needle)
1423 Grasp(Left, Needle):0	Pull(Left, Needle):10	Pull(Left, Needle):10	 ->Pull(Left, Needle)
1424 Grasp(Left, Needle):0	Pull(Left, Needle):10	Pull(Left, Needle):10	 ->Pull(Left, Needle)
1425 Grasp(Left, Needle):0	Pull(Left, Needle):10	Pull(Left, Needle):10	 ->Pull(Left, Needle)
1426 Grasp(Left, Needle):0	Pull(Left, Needle):10	Pull(Left, Needle):10	 ->Pull(Left, Needle)
1427 Grasp(Left, Needle):0	Pull(Left, Needle):10	Pull(Left, Needle):10	 ->Pull(Left, Needle)
1428 Pull(Left, Needle):10	Pull(Left, Needle):10	Pull(Left, Needle):10	 ->Pull(Left, Needle)
1429 Pull(Left, Needle):10	Pull(Left, Needle):10	Pull(Left, Needle):10	 ->Pull(Left, Needle)
1430 Pull(Left, Needle):10	Pull(Left, Needle):10	Pull(Left, Needle):10	 ->Pull(Left, Needle)
1431 Pull(Left, Needle):10	Pull(Left, Needle):10	Pull(Left, Needle):10	 ->Pull(Left, Needle)
1432 Pull(Left, Needle):10	Pull(Left, Needle):10	Pull(Left, Needle):10	 ->Pull(Left, Needle)
1433 Pull(Left, Needle):10	Pull(Left, Needle):10	Pull(Left, Needle):10	 ->Pull(Left, Needle)
1434 Pull(Left, Needle):10	Pull(Left, Needle):10	Pull(Left, Needle):10	 ->Pull(Left, Needle)
1435 Pull(Left, Needle):10	Pull(Left, Needle):10	Pull(Left, Needle):10	 ->Pull(Left, Needle)
1436 Pull(Left, Needle):10	Pull(Left, Needle):10	Pull(Left, Needle):10	 ->Pull(Left, Needle)
1437 Pull(Left, Needle):10	Pull(Left, Needle):10	Pull(Left, Needle):10	 ->Pull(Left, Needle)
1438 Pull(Left, Needle):10	Pull(Left, Needle):10	Pull(Left, Needle):10	 ->Pull(Left, Needle)
1439 Pull(Left, Needle):10	Pull(Left, Needle):10	Pull(Left, Needle):10	 ->Pull(Left, Needle)
1440 Pull(Left, Needle):10	Pull(Left, Needle):10	Pull(Left, Needle):10	 ->Pull(Left, Needle)
1441 Pull(Left, Needle):10	Pull(Left, Needle):10	Pull(Left, Needle):10	 ->Pull(Left, Needle)
1442 Pull(Left, Needle):10	Pull(Left, Needle):10	Pull(Left, Needle):10	 ->Pull(Left, Needle)
1443 Pull(Left, Needle):10	Pull(Left, Needle):10	Pull(Left, Needle):10	 ->Pull(Left, Needle)
1444 Pull(Left, Needle):10	Pull(Left, Needle):10	Pull(Left, Needle):10	 ->Pull(Left, Needle)
1445 Pull(Left, Needle):10	Pull(Left, Needle):10	Pull(Left, Needle):10	 ->Pull(Left, Needle)
1446 Pull(Left, Needle):10	Pull(Left, Needle):10	Pull(Left, Needle):10	 ->Pull(Left, Needle)
1447 Pull(Left, Needle):10	Pull(Left, Needle):10	Pull(Left, Needle):10	 ->Pull(Left, Needle)
1448 Pull(Left, Needle):10	Pull(Left, Needle):10	Pull(Left, Needle):10	 ->Pull(Left, Needle)
1449 Pull(Left, Needle):10	Pull(Left, Needle):10	Pull(Left, Needle):10	 ->Pull(Left, Needle)
1450 Pull(Left, Needle):10	Pull(Left, Needle):10	Pull(Left, Needle):10	 ->Pull(Left, Needle)
1451 Pull(Left, Needle):10	Pull(Left, Needle):10	Pull(Left, Needle):10	 ->Pull(Left, Needle)
1452 Pull(Left, Needle):10	Pull(Left, Needle):10	Pull(Left, Needle):10	 ->Pull(Left, Needle)
1453 Pull(Left, Needle):10	Pull(Left, Needle):10	Pull(Left, Needle):10	 ->Pull(Left, Needle)
1454 Pull(Left, Needle):10	Pull(Left, Needle):10	Pull(Left, Needle):10	 ->Pull(Left, Needle)
1455 Pull(Left, Needle):10	Pull(Left, Needle):10	Pull(Left, Needle):10	 ->Pull(Left, Needle)
1456 Pull(Left, Needle):10	Pull(Left, Needle):10	Pull(Left, Needle):10	 ->Pull(Left, Needle)
1457 Pull(Left, Needle):10	Pull(Left, Needle):10	Pull(Left, Needle):10	 ->Pull(Left, Needle)
1458 Pull(Left, Needle):10	Pull(Left, Needle):10	Pull(Left, Needle):10	 ->Pull(Left, Needle)
1459 Pull(Left, Needle):10	Pull(Left, Needle):10	Pull(Left, Needle):10	 ->Pull(Left, Needle)
1460 Pull(Left, Needle):10	Pull(Left, Needle):10	Pull(Left, Needle):10	 ->Pull(Left, Needle)
1461 Pull(Left, Needle):10	Pull(Left, Needle):10	Pull(Left, Needle):10	 ->Pull(Left, Needle)
1462 Pull(Left, Needle):10	Pull(Left, Needle):10	Pull(Left, Needle):10	 ->Pull(Left, Needle)
1463 Pull(Left, Needle):10	Pull(Left, Needle):10	Pull(Left, Needle):10	 ->Pull(Left, Needle)
1464 Pull(Left, Needle):10	Pull(Left, Needle):10	Pull(Left, Needle):10	 ->Pull(Left, Needle)
1465 Pull(Left, Needle):10	Pull(Left, Needle):10	Pull(Left, Needle):10	 ->Pull(Left, Needle)
1466 Pull(Left, Needle):10	Pull(Left, Needle):10	Pull(Left, Needle):10	 ->Pull(Left, Needle)
1467 Pull(Left, Needle):10	Pull(Left, Needle):10	Pull(Left, Needle):10	 ->Pull(Left, Needle)
1468 Pull(Left, Needle):10	Pull(Left, Needle):10	Pull(Left, Needle):10	 ->Pull(Left, Needle)
1469 Pull(Left, Needle):10	Pull(Left, Needle):10	Pull(Left, Needle):10	 ->Pull(Left, Needle)
1470 Pull(Left, Needle):10	Pull(Left, Needle):10	Pull(Left, Needle):10	 ->Pull(Left, Needle)
1471 Pull(Left, Needle):10	Pull(Left, Needle):10	Pull(Left, Needle):10	 ->Pull(Left, Needle)
1472 Pull(Left, Needle):10	Pull(Left, Needle):10	Pull(Left, Needle):10	 ->Pull(Left, Needle)
1473 Pull(Left, Needle):10	Pull(Left, Needle):10	Pull(Left, Needle):10	 ->Pull(Left, Needle)
1474 Pull(Left, Needle):10	Pull(Left, Needle):10	Pull(Left, Needle):10	 ->Pull(Left, Needle)
1475 Pull(Left, Needle):10	Pull(Left, Needle):10	Pull(Left, Needle):10	 ->Pull(Left, Needle)
1476 Pull(Left, Needle):10	Pull(Left, Needle):10	Pull(Left, Needle):10	 ->Pull(Left, Needle)
1477 Pull(Left, Needle):10	Pull(Left, Needle):10	Pull(Left, Needle):10	 ->Pull(Left, Needle)
1478 Pull(Left, Needle):10	Pull(Left, Needle):10	Pull(Left, Needle):10	 ->Pull(Left, Needle)
1479 Pull(Left, Needle):10	Pull(Left, Needle):10	Pull(Left, Needle):10	 ->Pull(Left, Needle)
1480 Pull(Left, Needle):10	Pull(Left, Needle):10	Pull(Left, Needle):10	 ->Pull(Left, Needle)
1481 Pull(Left, Needle):10	Pull(Left, Needle):10	Pull(Left, Needle):10	 ->Pull(Left, Needle)
1482 Pull(Left, Needle):10	Pull(Left, Needle):10	Pull(Left, Needle):10	 ->Pull(Left, Needle)
1483 Pull(Left, Needle):10	Pull(Left, Needle):10	Pull(Left, Needle):10	 ->Pull(Left, Needle)
1484 Pull(Left, Needle):10	Pull(Left, Needle):10	Pull(Left, Needle):10	 ->Pull(Left, Needle)
1485 Pull(Left, Needle):10	Pull(Left, Needle):10	Pull(Left, Needle):10	 ->Pull(Left, Needle)
1486 Pull(Left, Needle):10	Pull(Left, Needle):10	Pull(Left, Needle):10	 ->Pull(Left, Needle)
1487 Pull(Left, Needle):10	Pull(Left, Needle):10	Pull(Left, Needle):10	 ->Pull(Left, Needle)
1488 Pull(Left, Needle):10	Pull(Left, Needle):10	Touch(Right, Needle):4	 ->Pull(Left, Needle)
1489 Pull(Left, Needle):10	Pull(Left, Needle):10	Touch(Right, Needle):4	 ->Pull(Left, Needle)
1490 Pull(Left, Needle):10	Pull(Left, Needle):10	Touch(Right, Needle):4	 ->Pull(Left, Needle)
1491 Pull(Left, Needle):10	Pull(Left, Needle):10	Touch(Right, Needle):4	 ->Pull(Left, Needle)
1492 Pull(Left, Needle):10	Pull(Left, Needle):10	Touch(Right, Needle):4	 ->Pull(Left, Needle)
1493 Pull(Left, Needle):10	Pull(Left, Needle):10	Touch(Right, Needle):4	 ->Pull(Left, Needle)
1494 Pull(Left, Needle):10	Pull(Left, Needle):10	Touch(Right, Needle):4	 ->Pull(Left, Needle)
1495 Pull(Left, Needle):10	Pull(Left, Needle):10	Touch(Right, Needle):4	 ->Pull(Left, Needle)
1496 Pull(Left, Needle):10	Pull(Left, Needle):10	Touch(Right, Needle):4	 ->Pull(Left, Needle)
1497 Pull(Left, Needle):10	Pull(Left, Needle):10	Touch(Right, Needle):4	 ->Pull(Left, Needle)
1498 Pull(Left, Needle):10	Pull(Left, Needle):10	Touch(Right, Needle):4	 ->Pull(Left, Needle)
1499 Pull(Left, Needle):10	Pull(Left, Needle):10	Touch(Right, Needle):4	 ->Pull(Left, Needle)
1500 Pull(Left, Needle):10	Pull(Left, Needle):10	Touch(Right, Needle):4	 ->Pull(Left, Needle)
1501 Pull(Left, Needle):10	Pull(Left, Needle):10	Touch(Right, Needle):4	 ->Pull(Left, Needle)
1502 Pull(Left, Needle):10	Pull(Left, Needle):10	Touch(Right, Needle):4	 ->Pull(Left, Needle)
1503 Pull(Left, Needle):10	Pull(Left, Needle):10	Touch(Right, Needle):4	 ->Pull(Left, Needle)
1504 Pull(Left, Needle):10	Pull(Left, Needle):10	Touch(Right, Needle):4	 ->Pull(Left, Needle)
1505 Pull(Left, Needle):10	Pull(Left, Needle):10	Touch(Right, Needle):4	 ->Pull(Left, Needle)
1506 Pull(Left, Needle):10	Pull(Left, Needle):10	Touch(Right, Needle):4	 ->Pull(Left, Needle)
1507 Pull(Left, Needle):10	Pull(Left, Needle):10	Touch(Right, Needle):4	 ->Pull(Left, Needle)
1508 Pull(Left, Needle):10	Pull(Left, Needle):10	Touch(Right, Needle):4	 ->Pull(Left, Needle)
1509 Pull(Left, Needle):10	Pull(Left, Needle):10	Touch(Right, Needle):4	 ->Pull(Left, Needle)
1510 Pull(Left, Needle):10	Pull(Left, Needle):10	Touch(Right, Needle):4	 ->Pull(Left, Needle)
1511 Pull(Left, Needle):10	Pull(Left, Needle):10	Touch(Right, Needle):4	 ->Pull(Left, Needle)
1512 Pull(Left, Needle):10	Pull(Left, Needle):10	Touch(Right, Needle):4	 ->Pull(Left, Needle)
1513 Pull(Left, Needle):10	Pull(Left, Needle):10	Touch(Right, Needle):4	 ->Pull(Left, Needle)
1514 Pull(Left, Needle):10	Pull(Left, Needle):10	Touch(Right, Needle):4	 ->Pull(Left, Needle)
1515 Pull(Left, Needle):10	Pull(Left, Needle):10	Touch(Right, Needle):4	 ->Pull(Left, Needle)
1516 Pull(Left, Needle):10	Pull(Left, Needle):10	Touch(Right, Needle):4	 ->Pull(Left, Needle)
1517 Pull(Left, Needle):10	Pull(Left, Needle):10	Touch(Right, Needle):4	 ->Pull(Left, Needle)
1518 Pull(Left, Needle):10	Pull(Left, Needle):10	Touch(Right, Needle):4	 ->Pull(Left, Needle)
1519 Pull(Left, Needle):10	Pull(Left, Needle):10	Touch(Right, Needle):4	 ->Pull(Left, Needle)
1520 Pull(Left, Needle):10	Pull(Left, Needle):10	Touch(Right, Needle):4	 ->Pull(Left, Needle)
1521 Pull(Left, Needle):10	Pull(Left, Needle):10	Touch(Right, Needle):4	 ->Pull(Left, Needle)
1522 Pull(Left, Needle):10	Pull(Left, Needle):10	Touch(Right, Needle):4	 ->Pull(Left, Needle)
1523 Pull(Left, Needle):10	Pull(Left, Needle):10	Touch(Right, Needle):4	 ->Pull(Left, Needle)
1524 Pull(Left, Needle):10	Pull(Left, Needle):10	Touch(Right, Needle):4	 ->Pull(Left, Needle)
1525 Pull(Left, Needle):10	Pull(Left, Needle):10	Touch(Right, Needle):4	 ->Pull(Left, Needle)
1526 Pull(Left, Needle):10	Pull(Left, Needle):10	Touch(Right, Needle):4	 ->Pull(Left, Needle)
1527 Pull(Left, Needle):10	Pull(Left, Needle):10	Touch(Right, Needle):4	 ->Pull(Left, Needle)
1528 Grasp(Right, Needle):1	Pull(Left, Needle):10	Touch(Right, Needle):4	 ->Grasp(Right, Needle)
1529 Grasp(Right, Needle):1	Pull(Left, Needle):10	Touch(Right, Needle):4	 ->Grasp(Right, Needle)
1530 Grasp(Right, Needle):1	Pull(Left, Needle):10	Touch(Right, Needle):4	 ->Grasp(Right, Needle)
1531 Grasp(Right, Needle):1	Pull(Left, Needle):10	Touch(Right, Needle):4	 ->Grasp(Right, Needle)
1532 Grasp(Right, Needle):1	Pull(Left, Needle):10	Touch(Right, Needle):4	 ->Grasp(Right, Needle)
1533 Grasp(Right, Needle):1	Pull(Left, Needle):10	Touch(Right, Needle):4	 ->Grasp(Right, Needle)
1534 Grasp(Right, Needle):1	Pull(Left, Needle):10	Touch(Right, Needle):4	 ->Grasp(Right, Needle)
1535 Grasp(Right, Needle):1	Pull(Left, Needle):10	Touch(Right, Needle):4	 ->Grasp(Right, Needle)
1536 Grasp(Right, Needle):1	Pull(Left, Needle):10	Touch(Right, Needle):4	 ->Grasp(Right, Needle)
1537 Grasp(Right, Needle):1	Pull(Left, Needle):10	Touch(Right, Needle):4	 ->Grasp(Right, Needle)
1538 Grasp(Right, Needle):1	Pull(Left, Needle):10	Touch(Right, Needle):4	 ->Grasp(Right, Needle)
1539 Grasp(Right, Needle):1	Pull(Left, Needle):10	Touch(Right, Needle):4	 ->Grasp(Right, Needle)
1540 Grasp(Right, Needle):1	Pull(Left, Needle):10	Touch(Right, Needle):4	 ->Grasp(Right, Needle)
1541 Grasp(Right, Needle):1	Pull(Left, Needle):10	Touch(Right, Needle):4	 ->Grasp(Right, Needle)
1542 Grasp(Right, Needle):1	Pull(Left, Needle):10	Touch(Right, Needle):4	 ->Grasp(Right, Needle)
1543 Grasp(Right, Needle):1	Pull(Left, Needle):10	Touch(Right, Needle):4	 ->Grasp(Right, Needle)
1544 Grasp(Right, Needle):1	Pull(Left, Needle):10	Grasp(Right, Needle):1	 ->Grasp(Right, Needle)
1545 Grasp(Right, Needle):1	Pull(Left, Needle):10	Grasp(Right, Needle):1	 ->Grasp(Right, Needle)
1546 Grasp(Right, Needle):1	Pull(Left, Needle):10	Grasp(Right, Needle):1	 ->Grasp(Right, Needle)
1547 Grasp(Right, Needle):1	Pull(Left, Needle):10	Grasp(Right, Needle):1	 ->Grasp(Right, Needle)
1548 Grasp(Right, Needle):1	Pull(Left, Needle):10	Grasp(Right, Needle):1	 ->Grasp(Right, Needle)
1549 Grasp(Right, Needle):1	Pull(Left, Needle):10	Grasp(Right, Needle):1	 ->Grasp(Right, Needle)
1550 Grasp(Right, Needle):1	Pull(Left, Needle):10	Grasp(Right, Needle):1	 ->Grasp(Right, Needle)
1551 Grasp(Right, Needle):1	Pull(Left, Needle):10	Grasp(Right, Needle):1	 ->Grasp(Right, Needle)
1552 Grasp(Right, Needle):1	Grasp(Right, Needle):1	Grasp(Right, Needle):1	 ->Grasp(Right, Needle)
1553 Grasp(Right, Needle):1	Grasp(Right, Needle):1	Grasp(Right, Needle):1	 ->Grasp(Right, Needle)
1554 Grasp(Right, Needle):1	Grasp(Right, Needle):1	Grasp(Right, Needle):1	 ->Grasp(Right, Needle)
1555 Grasp(Right, Needle):1	Grasp(Right, Needle):1	Grasp(Right, Needle):1	 ->Grasp(Right, Needle)
1556 Grasp(Right, Needle):1	Grasp(Right, Needle):1	Grasp(Right, Needle):1	 ->Grasp(Right, Needle)
1557 Grasp(Right, Needle):1	Grasp(Right, Needle):1	Grasp(Right, Needle):1	 ->Grasp(Right, Needle)
1558 Grasp(Right, Needle):1	Grasp(Right, Needle):1	Grasp(Right, Needle):1	 ->Grasp(Right, Needle)
1559 Grasp(Right, Needle):1	Grasp(Right, Needle):1	Grasp(Right, Needle):1	 ->Grasp(Right, Needle)
1560 Grasp(Right, Needle):1	Grasp(Right, Needle):1	Grasp(Right, Needle):1	 ->Grasp(Right, Needle)
1561 Grasp(Right, Needle):1	Grasp(Right, Needle):1	Release(Left, Needle):5	 ->Grasp(Right, Needle)
1562 Grasp(Right, Needle):1	Grasp(Right, Needle):1	Release(Left, Needle):5	 ->Grasp(Right, Needle)
1563 Grasp(Right, Needle):1	Grasp(Right, Needle):1	Release(Left, Needle):5	 ->Grasp(Right, Needle)
1564 Grasp(Right, Needle):1	Release(Left, Needle):5	Release(Left, Needle):5	 ->Release(Left, Needle)
1565 Grasp(Right, Needle):1	Release(Left, Needle):5	Release(Left, Needle):5	 ->Release(Left, Needle)
1566 Grasp(Right, Needle):1	Release(Left, Needle):5	Release(Left, Needle):5	 ->Release(Left, Needle)
1567 Grasp(Right, Needle):1	Release(Left, Needle):5	Release(Left, Needle):5	 ->Release(Left, Needle)
1568 Grasp(Right, Needle):1	Release(Left, Needle):5	Untouch(Left, Needle):6	 ->Grasp(Right, Needle)
1569 Grasp(Right, Needle):1	Release(Left, Needle):5	Untouch(Left, Needle):6	 ->Grasp(Right, Needle)
1570 Grasp(Right, Needle):1	Release(Left, Needle):5	Untouch(Left, Needle):6	 ->Grasp(Right, Needle)
1571 Grasp(Right, Needle):1	Release(Left, Needle):5	Untouch(Left, Needle):6	 ->Grasp(Right, Needle)
1572 Grasp(Right, Needle):1	Release(Left, Needle):5	Untouch(Left, Needle):6	 ->Grasp(Right, Needle)
1573 Grasp(Right, Needle):1	Release(Left, Needle):5	Untouch(Left, Needle):6	 ->Grasp(Right, Needle)
1574 Grasp(Right, Needle):1	Release(Left, Needle):5	Push(Right, Needle):7	 ->Grasp(Right, Needle)
1575 Grasp(Right, Needle):1	Release(Left, Needle):5	Push(Right, Needle):7	 ->Grasp(Right, Needle)
1576 Grasp(Right, Needle):1	Release(Left, Needle):5	Push(Right, Needle):7	 ->Grasp(Right, Needle)
1577 Grasp(Right, Needle):1	Release(Left, Needle):5	Push(Right, Needle):7	 ->Grasp(Right, Needle)
1578 Grasp(Right, Needle):1	Release(Left, Needle):5	Push(Right, Needle):7	 ->Grasp(Right, Needle)
1579 Grasp(Right, Needle):1	Release(Left, Needle):5	Push(Right, Needle):7	 ->Grasp(Right, Needle)
1580 Grasp(Right, Needle):1	Release(Left, Needle):5	Push(Right, Needle):7	 ->Grasp(Right, Needle)
1581 Grasp(Right, Needle):1	Release(Left, Needle):5	Push(Right, Needle):7	 ->Grasp(Right, Needle)
1582 Grasp(Right, Needle):1	Release(Left, Needle):5	Push(Right, Needle):7	 ->Grasp(Right, Needle)
1583 Grasp(Right, Needle):1	Release(Left, Needle):5	Push(Right, Needle):7	 ->Grasp(Right, Needle)
1584 Push(Right, Needle):7	Release(Left, Needle):5	Push(Right, Needle):7	 ->Push(Right, Needle)
1585 Push(Right, Needle):7	Release(Left, Needle):5	Push(Right, Needle):7	 ->Push(Right, Needle)
1586 Push(Right, Needle):7	Release(Left, Needle):5	Push(Right, Needle):7	 ->Push(Right, Needle)
1587 Push(Right, Needle):7	Release(Left, Needle):5	Push(Right, Needle):7	 ->Push(Right, Needle)
1588 Push(Right, Needle):7	Release(Left, Needle):5	Push(Right, Needle):7	 ->Push(Right, Needle)
1589 Push(Right, Needle):7	Release(Left, Needle):5	Push(Right, Needle):7	 ->Push(Right, Needle)
1590 Push(Right, Needle):7	Release(Left, Needle):5	Push(Right, Needle):7	 ->Push(Right, Needle)
1591 Push(Right, Needle):7	Release(Left, Needle):5	Push(Right, Needle):7	 ->Push(Right, Needle)
1592 Push(Right, Needle):7	Release(Left, Needle):5	Push(Right, Needle):7	 ->Push(Right, Needle)
1593 Push(Right, Needle):7	Release(Left, Needle):5	Push(Right, Needle):7	 ->Push(Right, Needle)
1594 Push(Right, Needle):7	Release(Left, Needle):5	Push(Right, Needle):7	 ->Push(Right, Needle)
1595 Push(Right, Needle):7	Release(Left, Needle):5	Push(Right, Needle):7	 ->Push(Right, Needle)
1596 Push(Right, Needle):7	Release(Left, Needle):5	Push(Right, Needle):7	 ->Push(Right, Needle)
1597 Push(Right, Needle):7	Release(Left, Needle):5	Push(Right, Needle):7	 ->Push(Right, Needle)
1598 Push(Right, Needle):7	Release(Left, Needle):5	Push(Right, Needle):7	 ->Push(Right, Needle)
1599 Push(Right, Needle):7	Release(Left, Needle):5	Push(Right, Needle):7	 ->Push(Right, Needle)
1600 Push(Right, Needle):7	Release(Left, Needle):5	Push(Right, Needle):7	 ->Push(Right, Needle)
1601 Push(Right, Needle):7	Release(Left, Needle):5	Push(Right, Needle):7	 ->Push(Right, Needle)
1602 Push(Right, Needle):7	Release(Left, Needle):5	Push(Right, Needle):7	 ->Push(Right, Needle)
1603 Push(Right, Needle):7	Release(Left, Needle):5	Push(Right, Needle):7	 ->Push(Right, Needle)
1604 Push(Right, Needle):7	Release(Left, Needle):5	Push(Right, Needle):7	 ->Push(Right, Needle)
1605 Push(Right, Needle):7	Release(Left, Needle):5	Push(Right, Needle):7	 ->Push(Right, Needle)
1606 Push(Right, Needle):7	Release(Left, Needle):5	Push(Right, Needle):7	 ->Push(Right, Needle)
1607 Push(Right, Needle):7	Release(Left, Needle):5	Push(Right, Needle):7	 ->Push(Right, Needle)
1608 Push(Right, Needle):7	Release(Left, Needle):5	Push(Right, Needle):7	 ->Push(Right, Needle)
1609 Push(Right, Needle):7	Release(Left, Needle):5	Push(Right, Needle):7	 ->Push(Right, Needle)
1610 Push(Right, Needle):7	Release(Left, Needle):5	Push(Right, Needle):7	 ->Push(Right, Needle)
1611 Push(Right, Needle):7	Release(Left, Needle):5	Push(Right, Needle):7	 ->Push(Right, Needle)
1612 Push(Right, Needle):7	Release(Left, Needle):5	Push(Right, Needle):7	 ->Push(Right, Needle)
1613 Push(Right, Needle):7	Release(Left, Needle):5	Push(Right, Needle):7	 ->Push(Right, Needle)
1614 Push(Right, Needle):7	Release(Left, Needle):5	Push(Right, Needle):7	 ->Push(Right, Needle)
1615 Push(Right, Needle):7	Release(Left, Needle):5	Push(Right, Needle):7	 ->Push(Right, Needle)
1616 Push(Right, Needle):7	Release(Left, Needle):5	Push(Right, Needle):7	 ->Push(Right, Needle)
1617 Push(Right, Needle):7	Release(Left, Needle):5	Push(Right, Needle):7	 ->Push(Right, Needle)
1618 Push(Right, Needle):7	Release(Left, Needle):5	Push(Right, Needle):7	 ->Push(Right, Needle)
1619 Push(Right, Needle):7	Release(Left, Needle):5	Push(Right, Needle):7	 ->Push(Right, Needle)
1620 Push(Right, Needle):7	Release(Left, Needle):5	Push(Right, Needle):7	 ->Push(Right, Needle)
1621 Push(Right, Needle):7	Release(Left, Needle):5	Push(Right, Needle):7	 ->Push(Right, Needle)
1622 Push(Right, Needle):7	Release(Left, Needle):5	Push(Right, Needle):7	 ->Push(Right, Needle)
1623 Push(Right, Needle):7	Release(Left, Needle):5	Push(Right, Needle):7	 ->Push(Right, Needle)
1624 Push(Right, Needle):7	Release(Left, Needle):5	Push(Right, Needle):7	 ->Push(Right, Needle)
1625 Push(Right, Needle):7	Release(Left, Needle):5	Push(Right, Needle):7	 ->Push(Right, Needle)
1626 Push(Right, Needle):7	Release(Left, Needle):5	Push(Right, Needle):7	 ->Push(Right, Needle)
1627 Push(Right, Needle):7	Release(Left, Needle):5	Push(Right, Needle):7	 ->Push(Right, Needle)
1628 Push(Right, Needle):7	Release(Left, Needle):5	Push(Right, Needle):7	 ->Push(Right, Needle)
1629 Push(Right, Needle):7	Release(Left, Needle):5	Push(Right, Needle):7	 ->Push(Right, Needle)
1630 Push(Right, Needle):7	Release(Left, Needle):5	Push(Right, Needle):7	 ->Push(Right, Needle)
1631 Push(Right, Needle):7	Release(Left, Needle):5	Push(Right, Needle):7	 ->Push(Right, Needle)
1632 Push(Right, Needle):7	Release(Left, Needle):5	Push(Right, Needle):7	 ->Push(Right, Needle)
1633 Push(Right, Needle):7	Release(Left, Needle):5	Push(Right, Needle):7	 ->Push(Right, Needle)
1634 Push(Right, Needle):7	Release(Left, Needle):5	Push(Right, Needle):7	 ->Push(Right, Needle)
1635 Push(Right, Needle):7	Release(Left, Needle):5	Push(Right, Needle):7	 ->Push(Right, Needle)
1636 Push(Right, Needle):7	Release(Left, Needle):5	Push(Right, Needle):7	 ->Push(Right, Needle)
1637 Push(Right, Needle):7	Release(Left, Needle):5	Push(Right, Needle):7	 ->Push(Right, Needle)
1638 Push(Right, Needle):7	Release(Left, Needle):5	Push(Right, Needle):7	 ->Push(Right, Needle)
1639 Push(Right, Needle):7	Release(Left, Needle):5	Push(Right, Needle):7	 ->Push(Right, Needle)
1640 Push(Right, Needle):7	Release(Left, Needle):5	Push(Right, Needle):7	 ->Push(Right, Needle)
1641 Push(Right, Needle):7	Release(Left, Needle):5	Push(Right, Needle):7	 ->Push(Right, Needle)
1642 Push(Right, Needle):7	Release(Left, Needle):5	Push(Right, Needle):7	 ->Push(Right, Needle)
1643 Push(Right, Needle):7	Release(Left, Needle):5	Push(Right, Needle):7	 ->Push(Right, Needle)
1644 Push(Right, Needle):7	Release(Left, Needle):5	Push(Right, Needle):7	 ->Push(Right, Needle)
1645 Push(Right, Needle):7	Release(Left, Needle):5	Push(Right, Needle):7	 ->Push(Right, Needle)
1646 Push(Right, Needle):7	Release(Left, Needle):5	Push(Right, Needle):7	 ->Push(Right, Needle)
1647 Push(Right, Needle):7	Release(Left, Needle):5	Push(Right, Needle):7	 ->Push(Right, Needle)
1648 Push(Right, Needle):7	Release(Left, Needle):5	Push(Right, Needle):7	 ->Push(Right, Needle)
1649 Push(Right, Needle):7	Release(Left, Needle):5	Push(Right, Needle):7	 ->Push(Right, Needle)
1650 Push(Right, Needle):7	Release(Left, Needle):5	Push(Right, Needle):7	 ->Push(Right, Needle)
1651 Push(Right, Needle):7	Release(Left, Needle):5	Push(Right, Needle):7	 ->Push(Right, Needle)
1652 Push(Right, Needle):7	Release(Left, Needle):5	Push(Right, Needle):7	 ->Push(Right, Needle)
1653 Push(Right, Needle):7	Release(Left, Needle):5	Push(Right, Needle):7	 ->Push(Right, Needle)
1654 Push(Right, Needle):7	Release(Left, Needle):5	Push(Right, Needle):7	 ->Push(Right, Needle)
1655 Push(Right, Needle):7	Release(Left, Needle):5	Push(Right, Needle):7	 ->Push(Right, Needle)
1656 Push(Right, Needle):7	Release(Left, Needle):5	Push(Right, Needle):7	 ->Push(Right, Needle)
1657 Push(Right, Needle):7	Release(Left, Needle):5	Push(Right, Needle):7	 ->Push(Right, Needle)
1658 Push(Right, Needle):7	Release(Left, Needle):5	Push(Right, Needle):7	 ->Push(Right, Needle)
1659 Push(Right, Needle):7	Release(Left, Needle):5	Push(Right, Needle):7	 ->Push(Right, Needle)
1660 Push(Right, Needle):7	Release(Left, Needle):5	Push(Right, Needle):7	 ->Push(Right, Needle)
1661 Push(Right, Needle):7	Release(Left, Needle):5	Push(Right, Needle):7	 ->Push(Right, Needle)
1662 Push(Right, Needle):7	Release(Left, Needle):5	Push(Right, Needle):7	 ->Push(Right, Needle)
1663 Push(Right, Needle):7	Release(Left, Needle):5	Push(Right, Needle):7	 ->Push(Right, Needle)
1664 Push(Right, Needle):7	Release(Left, Needle):5	Push(Right, Needle):7	 ->Push(Right, Needle)
1665 Push(Right, Needle):7	Release(Left, Needle):5	Push(Right, Needle):7	 ->Push(Right, Needle)
1666 Push(Right, Needle):7	Release(Left, Needle):5	Push(Right, Needle):7	 ->Push(Right, Needle)
1667 Push(Right, Needle):7	Release(Left, Needle):5	Push(Right, Needle):7	 ->Push(Right, Needle)
1668 Push(Right, Needle):7	Release(Left, Needle):5	Push(Right, Needle):7	 ->Push(Right, Needle)
1669 Push(Right, Needle):7	Release(Left, Needle):5	Push(Right, Needle):7	 ->Push(Right, Needle)
1670 Push(Right, Needle):7	Release(Left, Needle):5	Push(Right, Needle):7	 ->Push(Right, Needle)
1671 Push(Right, Needle):7	Release(Left, Needle):5	Push(Right, Needle):7	 ->Push(Right, Needle)
1672 Push(Right, Needle):7	Release(Left, Needle):5	Push(Right, Needle):7	 ->Push(Right, Needle)
1673 Push(Right, Needle):7	Release(Left, Needle):5	Push(Right, Needle):7	 ->Push(Right, Needle)
1674 Push(Right, Needle):7	Release(Left, Needle):5	Push(Right, Needle):7	 ->Push(Right, Needle)
1675 Push(Right, Needle):7	Release(Left, Needle):5	Push(Right, Needle):7	 ->Push(Right, Needle)
1676 Push(Right, Needle):7	Release(Left, Needle):5	Push(Right, Needle):7	 ->Push(Right, Needle)
1677 Push(Right, Needle):7	Release(Left, Needle):5	Push(Right, Needle):7	 ->Push(Right, Needle)
1678 Push(Right, Needle):7	Release(Left, Needle):5	Push(Right, Needle):7	 ->Push(Right, Needle)
1679 Push(Right, Needle):7	Release(Left, Needle):5	Push(Right, Needle):7	 ->Push(Right, Needle)
1680 Push(Right, Needle):7	Release(Left, Needle):5	Push(Right, Needle):7	 ->Push(Right, Needle)
1681 Push(Right, Needle):7	Release(Left, Needle):5	Push(Right, Needle):7	 ->Push(Right, Needle)
1682 Push(Right, Needle):7	Release(Left, Needle):5	Push(Right, Needle):7	 ->Push(Right, Needle)
1683 Push(Right, Needle):7	Release(Left, Needle):5	Push(Right, Needle):7	 ->Push(Right, Needle)
1684 Push(Right, Needle):7	Release(Left, Needle):5	Push(Right, Needle):7	 ->Push(Right, Needle)
1685 Push(Right, Needle):7	Touch(Needle, Fabric/Tissue):8	Push(Right, Needle):7	 ->Push(Right, Needle)
1686 Push(Right, Needle):7	Touch(Needle, Fabric/Tissue):8	Push(Right, Needle):7	 ->Push(Right, Needle)
1687 Push(Right, Needle):7	Touch(Needle, Fabric/Tissue):8	Push(Right, Needle):7	 ->Push(Right, Needle)
1688 Push(Right, Needle):7	Touch(Needle, Fabric/Tissue):8	Push(Right, Needle):7	 ->Push(Right, Needle)
1689 Push(Right, Needle):7	Touch(Needle, Fabric/Tissue):8	Push(Right, Needle):7	 ->Push(Right, Needle)
1690 Push(Right, Needle):7	Touch(Needle, Fabric/Tissue):8	Push(Right, Needle):7	 ->Push(Right, Needle)
1691 Push(Right, Needle):7	Touch(Needle, Fabric/Tissue):8	Push(Right, Needle):7	 ->Push(Right, Needle)
1692 Push(Right, Needle):7	Touch(Needle, Fabric/Tissue):8	Push(Right, Needle):7	 ->Push(Right, Needle)
1693 Push(Right, Needle):7	Touch(Needle, Fabric/Tissue):8	Push(Right, Needle):7	 ->Push(Right, Needle)
1694 Push(Right, Needle):7	Touch(Needle, Fabric/Tissue):8	Push(Right, Needle):7	 ->Push(Right, Needle)
1695 Push(Right, Needle):7	Touch(Needle, Fabric/Tissue):8	Push(Right, Needle):7	 ->Push(Right, Needle)
1696 Push(Right, Needle):7	Touch(Needle, Fabric/Tissue):8	Push(Right, Needle):7	 ->Push(Right, Needle)
1697 Push(Right, Needle):7	Touch(Needle, Fabric/Tissue):8	Push(Right, Needle):7	 ->Push(Right, Needle)
1698 Push(Right, Needle):7	Touch(Needle, Fabric/Tissue):8	Push(Right, Needle):7	 ->Push(Right, Needle)
1699 Push(Right, Needle):7	Touch(Needle, Fabric/Tissue):8	Push(Right, Needle):7	 ->Push(Right, Needle)
1700 Push(Right, Needle):7	Touch(Needle, Fabric/Tissue):8	Push(Right, Needle):7	 ->Push(Right, Needle)
1701 Push(Right, Needle):7	Touch(Needle, Fabric/Tissue):8	Push(Right, Needle):7	 ->Push(Right, Needle)
1702 Push(Right, Needle):7	Touch(Needle, Fabric/Tissue):8	Push(Right, Needle):7	 ->Push(Right, Needle)
1703 Push(Right, Needle):7	Touch(Needle, Fabric/Tissue):8	Push(Right, Needle):7	 ->Push(Right, Needle)
1704 Push(Right, Needle):7	Touch(Needle, Fabric/Tissue):8	Push(Right, Needle):7	 ->Push(Right, Needle)
1705 Push(Right, Needle):7	Touch(Needle, Fabric/Tissue):8	Push(Right, Needle):7	 ->Push(Right, Needle)
1706 Push(Right, Needle):7	Touch(Needle, Fabric/Tissue):8	Push(Right, Needle):7	 ->Push(Right, Needle)
1707 Push(Right, Needle):7	Touch(Needle, Fabric/Tissue):8	Push(Right, Needle):7	 ->Push(Right, Needle)
1708 Push(Right, Needle):7	Touch(Needle, Fabric/Tissue):8	Push(Right, Needle):7	 ->Push(Right, Needle)
1709 Push(Right, Needle):7	Push(Right, Needle):7	Push(Right, Needle):7	 ->Push(Right, Needle)
1710 Push(Right, Needle):7	Push(Right, Needle):7	Push(Right, Needle):7	 ->Push(Right, Needle)
1711 Push(Right, Needle):7	Push(Right, Needle):7	Push(Right, Needle):7	 ->Push(Right, Needle)
1712 Push(Right, Needle):7	Push(Right, Needle):7	Push(Right, Needle):7	 ->Push(Right, Needle)
1713 Push(Right, Needle):7	Push(Right, Needle):7	Push(Right, Needle):7	 ->Push(Right, Needle)
1714 Push(Right, Needle):7	Push(Right, Needle):7	Push(Right, Needle):7	 ->Push(Right, Needle)
1715 Push(Right, Needle):7	Push(Right, Needle):7	Push(Right, Needle):7	 ->Push(Right, Needle)
1716 Push(Right, Needle):7	Push(Right, Needle):7	Push(Right, Needle):7	 ->Push(Right, Needle)
1717 Push(Right, Needle):7	Push(Right, Needle):7	Push(Right, Needle):7	 ->Push(Right, Needle)
1718 Push(Right, Needle):7	Push(Right, Needle):7	Push(Right, Needle):7	 ->Push(Right, Needle)
1719 Push(Right, Needle):7	Push(Right, Needle):7	Push(Right, Needle):7	 ->Push(Right, Needle)
1720 Push(Right, Needle):7	Push(Right, Needle):7	Push(Right, Needle):7	 ->Push(Right, Needle)
1721 Push(Right, Needle):7	Push(Right, Needle):7	Push(Right, Needle):7	 ->Push(Right, Needle)
1722 Push(Right, Needle):7	Push(Right, Needle):7	Push(Right, Needle):7	 ->Push(Right, Needle)
1723 Push(Right, Needle):7	Push(Right, Needle):7	Push(Right, Needle):7	 ->Push(Right, Needle)
1724 Push(Right, Needle):7	Push(Right, Needle):7	Push(Right, Needle):7	 ->Push(Right, Needle)
1725 Push(Right, Needle):7	Push(Right, Needle):7	Push(Right, Needle):7	 ->Push(Right, Needle)
1726 Push(Right, Needle):7	Push(Right, Needle):7	Push(Right, Needle):7	 ->Push(Right, Needle)
1727 Push(Right, Needle):7	Push(Right, Needle):7	Push(Right, Needle):7	 ->Push(Right, Needle)
1728 Push(Right, Needle):7	Push(Right, Needle):7	Push(Right, Needle):7	 ->Push(Right, Needle)
1729 Push(Right, Needle):7	Push(Right, Needle):7	Push(Right, Needle):7	 ->Push(Right, Needle)
1730 Push(Right, Needle):7	Push(Right, Needle):7	Push(Right, Needle):7	 ->Push(Right, Needle)
1731 Push(Right, Needle):7	Push(Right, Needle):7	Push(Right, Needle):7	 ->Push(Right, Needle)
1732 Push(Right, Needle):7	Push(Right, Needle):7	Push(Right, Needle):7	 ->Push(Right, Needle)
1733 Push(Right, Needle):7	Push(Right, Needle):7	Push(Right, Needle):7	 ->Push(Right, Needle)
1734 Push(Right, Needle):7	Push(Right, Needle):7	Push(Right, Needle):7	 ->Push(Right, Needle)
1735 Push(Right, Needle):7	Push(Right, Needle):7	Push(Right, Needle):7	 ->Push(Right, Needle)
1736 Push(Right, Needle):7	Push(Right, Needle):7	Push(Right, Needle):7	 ->Push(Right, Needle)
1737 Push(Right, Needle):7	Push(Right, Needle):7	Push(Right, Needle):7	 ->Push(Right, Needle)
1738 Push(Right, Needle):7	Push(Right, Needle):7	Push(Right, Needle):7	 ->Push(Right, Needle)
1739 Push(Right, Needle):7	Push(Right, Needle):7	Push(Right, Needle):7	 ->Push(Right, Needle)
1740 Push(Right, Needle):7	Push(Right, Needle):7	Push(Right, Needle):7	 ->Push(Right, Needle)
1741 Push(Right, Needle):7	Push(Right, Needle):7	Push(Right, Needle):7	 ->Push(Right, Needle)
1742 Push(Right, Needle):7	Push(Right, Needle):7	Push(Right, Needle):7	 ->Push(Right, Needle)
1743 Push(Right, Needle):7	Push(Right, Needle):7	Push(Right, Needle):7	 ->Push(Right, Needle)
1744 Push(Right, Needle):7	Push(Right, Needle):7	Push(Right, Needle):7	 ->Push(Right, Needle)
1745 Push(Right, Needle):7	Push(Right, Needle):7	Push(Right, Needle):7	 ->Push(Right, Needle)
1746 Push(Right, Needle):7	Push(Right, Needle):7	Push(Right, Needle):7	 ->Push(Right, Needle)
1747 Push(Right, Needle):7	Push(Right, Needle):7	Push(Right, Needle):7	 ->Push(Right, Needle)
1748 Push(Right, Needle):7	Push(Right, Needle):7	Push(Right, Needle):7	 ->Push(Right, Needle)
1749 Push(Right, Needle):7	Push(Right, Needle):7	Push(Right, Needle):7	 ->Push(Right, Needle)
1750 Push(Right, Needle):7	Push(Right, Needle):7	Push(Right, Needle):7	 ->Push(Right, Needle)
1751 Push(Right, Needle):7	Push(Right, Needle):7	Push(Right, Needle):7	 ->Push(Right, Needle)
1752 Push(Right, Needle):7	Push(Right, Needle):7	Push(Right, Needle):7	 ->Push(Right, Needle)
1753 Push(Right, Needle):7	Push(Right, Needle):7	Push(Right, Needle):7	 ->Push(Right, Needle)
1754 Push(Right, Needle):7	Push(Right, Needle):7	Push(Right, Needle):7	 ->Push(Right, Needle)
1755 Push(Right, Needle):7	Push(Right, Needle):7	Push(Right, Needle):7	 ->Push(Right, Needle)
1756 Push(Right, Needle):7	Push(Right, Needle):7	Push(Right, Needle):7	 ->Push(Right, Needle)
1757 Push(Right, Needle):7	Push(Right, Needle):7	Push(Right, Needle):7	 ->Push(Right, Needle)
1758 Push(Right, Needle):7	Push(Right, Needle):7	Push(Right, Needle):7	 ->Push(Right, Needle)
1759 Push(Right, Needle):7	Push(Right, Needle):7	Push(Right, Needle):7	 ->Push(Right, Needle)
1760 Push(Right, Needle):7	Push(Right, Needle):7	Push(Right, Needle):7	 ->Push(Right, Needle)
1761 Push(Right, Needle):7	Push(Right, Needle):7	Push(Right, Needle):7	 ->Push(Right, Needle)
1762 Push(Right, Needle):7	Push(Right, Needle):7	Push(Right, Needle):7	 ->Push(Right, Needle)
1763 Push(Right, Needle):7	Push(Right, Needle):7	Push(Right, Needle):7	 ->Push(Right, Needle)
1764 Push(Right, Needle):7	Push(Right, Needle):7	Push(Right, Needle):7	 ->Push(Right, Needle)
1765 Push(Right, Needle):7	Push(Right, Needle):7	Push(Right, Needle):7	 ->Push(Right, Needle)
1766 Push(Right, Needle):7	Push(Right, Needle):7	Push(Right, Needle):7	 ->Push(Right, Needle)
1767 Push(Right, Needle):7	Push(Right, Needle):7	Push(Right, Needle):7	 ->Push(Right, Needle)
1768 Push(Right, Needle):7	Push(Right, Needle):7	Push(Right, Needle):7	 ->Push(Right, Needle)
1769 Push(Right, Needle):7	Push(Right, Needle):7	Push(Right, Needle):7	 ->Push(Right, Needle)
1770 Push(Right, Needle):7	Push(Right, Needle):7	Push(Right, Needle):7	 ->Push(Right, Needle)
1771 Push(Right, Needle):7	Push(Right, Needle):7	Push(Right, Needle):7	 ->Push(Right, Needle)
1772 Push(Right, Needle):7	Push(Right, Needle):7	Push(Right, Needle):7	 ->Push(Right, Needle)
1773 Push(Right, Needle):7	Push(Right, Needle):7	Push(Right, Needle):7	 ->Push(Right, Needle)
1774 Push(Right, Needle):7	Push(Right, Needle):7	Push(Right, Needle):7	 ->Push(Right, Needle)
1775 Push(Right, Needle):7	Push(Right, Needle):7	Push(Right, Needle):7	 ->Push(Right, Needle)
1776 Push(Right, Needle):7	Push(Right, Needle):7	Push(Right, Needle):7	 ->Push(Right, Needle)
1777 Push(Right, Needle):7	Push(Right, Needle):7	Push(Right, Needle):7	 ->Push(Right, Needle)
1778 Push(Right, Needle):7	Push(Right, Needle):7	Push(Right, Needle):7	 ->Push(Right, Needle)
1779 Push(Right, Needle):7	Push(Right, Needle):7	Push(Right, Needle):7	 ->Push(Right, Needle)
1780 Push(Right, Needle):7	Push(Right, Needle):7	Push(Right, Needle):7	 ->Push(Right, Needle)
1781 Push(Right, Needle):7	Push(Right, Needle):7	Push(Right, Needle):7	 ->Push(Right, Needle)
1782 Push(Right, Needle):7	Push(Right, Needle):7	Push(Right, Needle):7	 ->Push(Right, Needle)
1783 Push(Right, Needle):7	Push(Right, Needle):7	Push(Right, Needle):7	 ->Push(Right, Needle)
1784 Push(Right, Needle):7	Push(Right, Needle):7	Push(Right, Needle):7	 ->Push(Right, Needle)
1785 Push(Right, Needle):7	Push(Right, Needle):7	Push(Right, Needle):7	 ->Push(Right, Needle)
1786 Push(Right, Needle):7	Push(Right, Needle):7	Push(Right, Needle):7	 ->Push(Right, Needle)
1787 Push(Right, Needle):7	Push(Right, Needle):7	Push(Right, Needle):7	 ->Push(Right, Needle)
1788 Push(Right, Needle):7	Push(Right, Needle):7	Push(Right, Needle):7	 ->Push(Right, Needle)
1789 Push(Right, Needle):7	Push(Right, Needle):7	Push(Right, Needle):7	 ->Push(Right, Needle)
1790 Push(Right, Needle):7	Push(Right, Needle):7	Push(Right, Needle):7	 ->Push(Right, Needle)
1791 Push(Right, Needle):7	Push(Right, Needle):7	Push(Right, Needle):7	 ->Push(Right, Needle)
1792 Push(Right, Needle):7	Push(Right, Needle):7	Push(Right, Needle):7	 ->Push(Right, Needle)
1793 Push(Right, Needle):7	Push(Right, Needle):7	Push(Right, Needle):7	 ->Push(Right, Needle)
1794 Push(Right, Needle):7	Push(Right, Needle):7	Push(Right, Needle):7	 ->Push(Right, Needle)
1795 Push(Right, Needle):7	Push(Right, Needle):7	Push(Right, Needle):7	 ->Push(Right, Needle)
1796 Push(Right, Needle):7	Push(Right, Needle):7	Push(Right, Needle):7	 ->Push(Right, Needle)
1797 Push(Right, Needle):7	Push(Right, Needle):7	Touch(Left, Needle):9	 ->Push(Right, Needle)
1798 Push(Right, Needle):7	Push(Right, Needle):7	Touch(Left, Needle):9	 ->Push(Right, Needle)
1799 Push(Right, Needle):7	Push(Right, Needle):7	Touch(Left, Needle):9	 ->Push(Right, Needle)
1800 Push(Right, Needle):7	Push(Right, Needle):7	Touch(Left, Needle):9	 ->Push(Right, Needle)
1801 Push(Right, Needle):7	Push(Right, Needle):7	Touch(Left, Needle):9	 ->Push(Right, Needle)
1802 Push(Right, Needle):7	Push(Right, Needle):7	Touch(Left, Needle):9	 ->Push(Right, Needle)
1803 Push(Right, Needle):7	Push(Right, Needle):7	Touch(Left, Needle):9	 ->Push(Right, Needle)
1804 Push(Right, Needle):7	Push(Right, Needle):7	Touch(Left, Needle):9	 ->Push(Right, Needle)
1805 Push(Right, Needle):7	Push(Right, Needle):7	Touch(Left, Needle):9	 ->Push(Right, Needle)
1806 Push(Right, Needle):7	Push(Right, Needle):7	Touch(Left, Needle):9	 ->Push(Right, Needle)
1807 Push(Right, Needle):7	Push(Right, Needle):7	Touch(Left, Needle):9	 ->Push(Right, Needle)
1808 Push(Right, Needle):7	Push(Right, Needle):7	Touch(Left, Needle):9	 ->Push(Right, Needle)
1809 Grasp(Left, Needle):0	Push(Right, Needle):7	Touch(Left, Needle):9	 ->Grasp(Left, Needle)
1810 Grasp(Left, Needle):0	Push(Right, Needle):7	Touch(Left, Needle):9	 ->Grasp(Left, Needle)
1811 Grasp(Left, Needle):0	Push(Right, Needle):7	Touch(Left, Needle):9	 ->Grasp(Left, Needle)
1812 Grasp(Left, Needle):0	Push(Right, Needle):7	Touch(Left, Needle):9	 ->Grasp(Left, Needle)
1813 Grasp(Left, Needle):0	Push(Right, Needle):7	Touch(Left, Needle):9	 ->Grasp(Left, Needle)
1814 Grasp(Left, Needle):0	Push(Right, Needle):7	Touch(Left, Needle):9	 ->Grasp(Left, Needle)
1815 Grasp(Left, Needle):0	Push(Right, Needle):7	Touch(Left, Needle):9	 ->Grasp(Left, Needle)
1816 Grasp(Left, Needle):0	Push(Right, Needle):7	Touch(Left, Needle):9	 ->Grasp(Left, Needle)
1817 Grasp(Left, Needle):0	Push(Right, Needle):7	Touch(Left, Needle):9	 ->Grasp(Left, Needle)
1818 Grasp(Left, Needle):0	Push(Right, Needle):7	Touch(Left, Needle):9	 ->Grasp(Left, Needle)
1819 Grasp(Left, Needle):0	Push(Right, Needle):7	Touch(Left, Needle):9	 ->Grasp(Left, Needle)
1820 Grasp(Left, Needle):0	Push(Right, Needle):7	Touch(Left, Needle):9	 ->Grasp(Left, Needle)
1821 Grasp(Left, Needle):0	Push(Right, Needle):7	Touch(Left, Needle):9	 ->Grasp(Left, Needle)
1822 Grasp(Left, Needle):0	Push(Right, Needle):7	Touch(Left, Needle):9	 ->Grasp(Left, Needle)
1823 Grasp(Left, Needle):0	Push(Right, Needle):7	Touch(Left, Needle):9	 ->Grasp(Left, Needle)
1824 Grasp(Left, Needle):0	Push(Right, Needle):7	Touch(Left, Needle):9	 ->Grasp(Left, Needle)
1825 Grasp(Left, Needle):0	Push(Right, Needle):7	Touch(Left, Needle):9	 ->Grasp(Left, Needle)
1826 Grasp(Left, Needle):0	Push(Right, Needle):7	Touch(Left, Needle):9	 ->Grasp(Left, Needle)
1827 Grasp(Left, Needle):0	Push(Right, Needle):7	Touch(Left, Needle):9	 ->Grasp(Left, Needle)
1828 Grasp(Left, Needle):0	Push(Right, Needle):7	Touch(Left, Needle):9	 ->Grasp(Left, Needle)
1829 Grasp(Left, Needle):0	Push(Right, Needle):7	Touch(Left, Needle):9	 ->Grasp(Left, Needle)
1830 Grasp(Left, Needle):0	Push(Right, Needle):7	Touch(Left, Needle):9	 ->Grasp(Left, Needle)
1831 Grasp(Left, Needle):0	Push(Right, Needle):7	Touch(Left, Needle):9	 ->Grasp(Left, Needle)
1832 Grasp(Left, Needle):0	Push(Right, Needle):7	Touch(Left, Needle):9	 ->Grasp(Left, Needle)
1833 Grasp(Left, Needle):0	Push(Right, Needle):7	Grasp(Left, Needle):0	 ->Grasp(Left, Needle)
1834 Grasp(Left, Needle):0	Push(Right, Needle):7	Grasp(Left, Needle):0	 ->Grasp(Left, Needle)
1835 Grasp(Left, Needle):0	Push(Right, Needle):7	Grasp(Left, Needle):0	 ->Grasp(Left, Needle)
1836 Grasp(Left, Needle):0	Push(Right, Needle):7	Grasp(Left, Needle):0	 ->Grasp(Left, Needle)
1837 Grasp(Left, Needle):0	Push(Right, Needle):7	Grasp(Left, Needle):0	 ->Grasp(Left, Needle)
1838 Grasp(Left, Needle):0	Push(Right, Needle):7	Grasp(Left, Needle):0	 ->Grasp(Left, Needle)
1839 Grasp(Left, Needle):0	Push(Right, Needle):7	Grasp(Left, Needle):0	 ->Grasp(Left, Needle)
1840 Grasp(Left, Needle):0	Push(Right, Needle):7	Grasp(Left, Needle):0	 ->Grasp(Left, Needle)
1841 Grasp(Left, Needle):0	Push(Right, Needle):7	Grasp(Left, Needle):0	 ->Grasp(Left, Needle)
1842 Grasp(Left, Needle):0	Push(Right, Needle):7	Grasp(Left, Needle):0	 ->Grasp(Left, Needle)
1843 Grasp(Left, Needle):0	Push(Right, Needle):7	Grasp(Left, Needle):0	 ->Grasp(Left, Needle)
1844 Grasp(Left, Needle):0	Push(Right, Needle):7	Release(Right, Needle):2	 ->Grasp(Left, Needle)
1845 Grasp(Left, Needle):0	Push(Right, Needle):7	Release(Right, Needle):2	 ->Grasp(Left, Needle)
1846 Grasp(Left, Needle):0	Push(Right, Needle):7	Release(Right, Needle):2	 ->Grasp(Left, Needle)
1847 Grasp(Left, Needle):0	Push(Right, Needle):7	Release(Right, Needle):2	 ->Grasp(Left, Needle)
1848 Grasp(Left, Needle):0	Push(Right, Needle):7	Release(Right, Needle):2	 ->Grasp(Left, Needle)
1849 Grasp(Left, Needle):0	Grasp(Left, Needle):0	Release(Right, Needle):2	 ->Grasp(Left, Needle)
1850 Grasp(Left, Needle):0	Grasp(Left, Needle):0	Release(Right, Needle):2	 ->Grasp(Left, Needle)
1851 Grasp(Left, Needle):0	Grasp(Left, Needle):0	Release(Right, Needle):2	 ->Grasp(Left, Needle)
1852 Grasp(Left, Needle):0	Grasp(Left, Needle):0	Release(Right, Needle):2	 ->Grasp(Left, Needle)
1853 Grasp(Left, Needle):0	Grasp(Left, Needle):0	Pull(Left, Needle):10	 ->Grasp(Left, Needle)
1854 Grasp(Left, Needle):0	Grasp(Left, Needle):0	Pull(Left, Needle):10	 ->Grasp(Left, Needle)
1855 Grasp(Left, Needle):0	Grasp(Left, Needle):0	Pull(Left, Needle):10	 ->Grasp(Left, Needle)
1856 Grasp(Left, Needle):0	Grasp(Left, Needle):0	Pull(Left, Needle):10	 ->Grasp(Left, Needle)
1857 Pull(Left, Needle):10	Release(Right, Needle):2	Pull(Left, Needle):10	 ->Pull(Left, Needle)
1858 Pull(Left, Needle):10	Release(Right, Needle):2	Pull(Left, Needle):10	 ->Pull(Left, Needle)
1859 Pull(Left, Needle):10	Release(Right, Needle):2	Pull(Left, Needle):10	 ->Pull(Left, Needle)
1860 Pull(Left, Needle):10	Release(Right, Needle):2	Pull(Left, Needle):10	 ->Pull(Left, Needle)
1861 Pull(Left, Needle):10	Release(Right, Needle):2	Pull(Left, Needle):10	 ->Pull(Left, Needle)
1862 Pull(Left, Needle):10	Pull(Left, Needle):10	Pull(Left, Needle):10	 ->Pull(Left, Needle)
1863 Pull(Left, Needle):10	Pull(Left, Needle):10	Pull(Left, Needle):10	 ->Pull(Left, Needle)
1864 Pull(Left, Needle):10	Pull(Left, Needle):10	Pull(Left, Needle):10	 ->Pull(Left, Needle)
1865 Pull(Left, Needle):10	Pull(Left, Needle):10	Pull(Left, Needle):10	 ->Pull(Left, Needle)
1866 Pull(Left, Needle):10	Pull(Left, Needle):10	Pull(Left, Needle):10	 ->Pull(Left, Needle)
1867 Pull(Left, Needle):10	Pull(Left, Needle):10	Pull(Left, Needle):10	 ->Pull(Left, Needle)
1868 Pull(Left, Needle):10	Pull(Left, Needle):10	Pull(Left, Needle):10	 ->Pull(Left, Needle)
1869 Pull(Left, Needle):10	Pull(Left, Needle):10	Pull(Left, Needle):10	 ->Pull(Left, Needle)
1870 Pull(Left, Needle):10	Pull(Left, Needle):10	Pull(Left, Needle):10	 ->Pull(Left, Needle)
1871 Pull(Left, Needle):10	Pull(Left, Needle):10	Pull(Left, Needle):10	 ->Pull(Left, Needle)
1872 Pull(Left, Needle):10	Pull(Left, Needle):10	Pull(Left, Needle):10	 ->Pull(Left, Needle)
1873 Pull(Left, Needle):10	Pull(Left, Needle):10	Pull(Left, Needle):10	 ->Pull(Left, Needle)
1874 Pull(Left, Needle):10	Pull(Left, Needle):10	Pull(Left, Needle):10	 ->Pull(Left, Needle)
1875 Pull(Left, Needle):10	Pull(Left, Needle):10	Pull(Left, Needle):10	 ->Pull(Left, Needle)
1876 Pull(Left, Needle):10	Pull(Left, Needle):10	Pull(Left, Needle):10	 ->Pull(Left, Needle)
1877 Pull(Left, Needle):10	Pull(Left, Needle):10	Pull(Left, Needle):10	 ->Pull(Left, Needle)
1878 Pull(Left, Needle):10	Pull(Left, Needle):10	Pull(Left, Needle):10	 ->Pull(Left, Needle)
1879 Pull(Left, Needle):10	Pull(Left, Needle):10	Pull(Left, Needle):10	 ->Pull(Left, Needle)
1880 Pull(Left, Needle):10	Pull(Left, Needle):10	Pull(Left, Needle):10	 ->Pull(Left, Needle)
1881 Pull(Left, Needle):10	Pull(Left, Needle):10	Pull(Left, Needle):10	 ->Pull(Left, Needle)
1882 Pull(Left, Needle):10	Pull(Left, Needle):10	Pull(Left, Needle):10	 ->Pull(Left, Needle)
1883 Pull(Left, Needle):10	Pull(Left, Needle):10	Pull(Left, Needle):10	 ->Pull(Left, Needle)
1884 Pull(Left, Needle):10	Pull(Left, Needle):10	Pull(Left, Needle):10	 ->Pull(Left, Needle)
1885 Pull(Left, Needle):10	Pull(Left, Needle):10	Pull(Left, Needle):10	 ->Pull(Left, Needle)
1886 Pull(Left, Needle):10	Pull(Left, Needle):10	Pull(Left, Needle):10	 ->Pull(Left, Needle)
1887 Pull(Left, Needle):10	Pull(Left, Needle):10	Pull(Left, Needle):10	 ->Pull(Left, Needle)
1888 Pull(Left, Needle):10	Pull(Left, Needle):10	Pull(Left, Needle):10	 ->Pull(Left, Needle)
1889 Pull(Left, Needle):10	Pull(Left, Needle):10	Pull(Left, Needle):10	 ->Pull(Left, Needle)
1890 Pull(Left, Needle):10	Pull(Left, Needle):10	Pull(Left, Needle):10	 ->Pull(Left, Needle)
1891 Pull(Left, Needle):10	Pull(Left, Needle):10	Pull(Left, Needle):10	 ->Pull(Left, Needle)
1892 Pull(Left, Needle):10	Pull(Left, Needle):10	Pull(Left, Needle):10	 ->Pull(Left, Needle)
1893 Pull(Left, Needle):10	Pull(Left, Needle):10	Pull(Left, Needle):10	 ->Pull(Left, Needle)
1894 Pull(Left, Needle):10	Pull(Left, Needle):10	Pull(Left, Needle):10	 ->Pull(Left, Needle)
1895 Pull(Left, Needle):10	Pull(Left, Needle):10	Pull(Left, Needle):10	 ->Pull(Left, Needle)
1896 Pull(Left, Needle):10	Pull(Left, Needle):10	Pull(Left, Needle):10	 ->Pull(Left, Needle)
1897 Pull(Left, Needle):10	Pull(Left, Needle):10	Pull(Left, Needle):10	 ->Pull(Left, Needle)
1898 Pull(Left, Needle):10	Pull(Left, Needle):10	Pull(Left, Needle):10	 ->Pull(Left, Needle)
1899 Pull(Left, Needle):10	Pull(Left, Needle):10	Pull(Left, Needle):10	 ->Pull(Left, Needle)
1900 Pull(Left, Needle):10	Pull(Left, Needle):10	Pull(Left, Needle):10	 ->Pull(Left, Needle)
1901 Pull(Left, Needle):10	Pull(Left, Needle):10	Pull(Left, Needle):10	 ->Pull(Left, Needle)
1902 Pull(Left, Needle):10	Pull(Left, Needle):10	Pull(Left, Needle):10	 ->Pull(Left, Needle)
1903 Pull(Left, Needle):10	Pull(Left, Needle):10	Pull(Left, Needle):10	 ->Pull(Left, Needle)
1904 Pull(Left, Needle):10	Pull(Left, Needle):10	Pull(Left, Needle):10	 ->Pull(Left, Needle)
1905 Pull(Left, Needle):10	Pull(Left, Needle):10	Pull(Left, Needle):10	 ->Pull(Left, Needle)
1906 Pull(Left, Needle):10	Pull(Left, Needle):10	Pull(Left, Needle):10	 ->Pull(Left, Needle)
1907 Pull(Left, Needle):10	Pull(Left, Needle):10	Pull(Left, Needle):10	 ->Pull(Left, Needle)
1908 Pull(Left, Needle):10	Pull(Left, Needle):10	Pull(Left, Needle):10	 ->Pull(Left, Needle)
1909 Pull(Left, Needle):10	Pull(Left, Needle):10	Pull(Left, Needle):10	 ->Pull(Left, Needle)
1910 Pull(Left, Needle):10	Pull(Left, Needle):10	Pull(Left, Needle):10	 ->Pull(Left, Needle)
1911 Pull(Left, Needle):10	Pull(Left, Needle):10	Pull(Left, Needle):10	 ->Pull(Left, Needle)
1912 Pull(Left, Needle):10	Pull(Left, Needle):10	Pull(Left, Needle):10	 ->Pull(Left, Needle)
1913 Pull(Left, Needle):10	Pull(Left, Needle):10	Pull(Left, Needle):10	 ->Pull(Left, Needle)
1914 Pull(Left, Needle):10	Pull(Left, Needle):10	Pull(Left, Needle):10	 ->Pull(Left, Needle)
1915 Pull(Left, Needle):10	Pull(Left, Needle):10	Pull(Left, Needle):10	 ->Pull(Left, Needle)
1916 Pull(Left, Needle):10	Pull(Left, Needle):10	Pull(Left, Needle):10	 ->Pull(Left, Needle)
1917 Pull(Left, Needle):10	Pull(Left, Needle):10	Pull(Left, Needle):10	 ->Pull(Left, Needle)
1918 Pull(Left, Needle):10	Pull(Left, Needle):10	Pull(Left, Needle):10	 ->Pull(Left, Needle)
1919 Pull(Left, Needle):10	Pull(Left, Needle):10	Pull(Left, Needle):10	 ->Pull(Left, Needle)
1920 Pull(Left, Needle):10	Pull(Left, Needle):10	Pull(Left, Needle):10	 ->Pull(Left, Needle)
