0 Grasp(Right, Needle):0	Grasp(Right, Needle):0	Touch(Right, Needle):1	 ->Grasp(Right, Needle)
1 Grasp(Right, Needle):0	Grasp(Right, Needle):0	Touch(Right, Needle):1	 ->Grasp(Right, Needle)
2 Grasp(Right, Needle):0	Grasp(Right, Needle):0	Touch(Right, Needle):1	 ->Grasp(Right, Needle)
3 Grasp(Right, Needle):0	Grasp(Right, Needle):0	Touch(Right, Needle):1	 ->Grasp(Right, Needle)
4 Grasp(Right, Needle):0	Grasp(Right, Needle):0	Touch(Right, Needle):1	 ->Grasp(Right, Needle)
5 Grasp(Right, Needle):0	Grasp(Right, Needle):0	Touch(Right, Needle):1	 ->Grasp(Right, Needle)
6 Grasp(Right, Needle):0	Grasp(Right, Needle):0	Touch(Right, Needle):1	 ->Grasp(Right, Needle)
7 Grasp(Right, Needle):0	Grasp(Right, Needle):0	Touch(Right, Needle):1	 ->Grasp(Right, Needle)
8 Grasp(Right, Needle):0	Grasp(Right, Needle):0	Touch(Right, Needle):1	 ->Grasp(Right, Needle)
9 Grasp(Right, Needle):0	Grasp(Right, Needle):0	Touch(Right, Needle):1	 ->Grasp(Right, Needle)
10 Grasp(Right, Needle):0	Grasp(Right, Needle):0	Touch(Right, Needle):1	 ->Grasp(Right, Needle)
11 Grasp(Right, Needle):0	Grasp(Right, Needle):0	Touch(Right, Needle):1	 ->Grasp(Right, Needle)
12 Grasp(Right, Needle):0	Grasp(Right, Needle):0	Touch(Right, Needle):1	 ->Grasp(Right, Needle)
13 Grasp(Right, Needle):0	Grasp(Right, Needle):0	Touch(Right, Needle):1	 ->Grasp(Right, Needle)
14 Grasp(Right, Needle):0	Grasp(Right, Needle):0	Touch(Right, Needle):1	 ->Grasp(Right, Needle)
15 Grasp(Right, Needle):0	Grasp(Right, Needle):0	Touch(Right, Needle):1	 ->Grasp(Right, Needle)
16 Grasp(Right, Needle):0	Grasp(Right, Needle):0	Touch(Right, Needle):1	 ->Grasp(Right, Needle)
17 Grasp(Right, Needle):0	Grasp(Right, Needle):0	Touch(Right, Needle):1	 ->Grasp(Right, Needle)
18 Grasp(Right, Needle):0	Grasp(Right, Needle):0	Touch(Right, Needle):1	 ->Grasp(Right, Needle)
19 Grasp(Right, Needle):0	Grasp(Right, Needle):0	Touch(Right, Needle):1	 ->Grasp(Right, Needle)
20 Grasp(Right, Needle):0	Grasp(Right, Needle):0	Touch(Right, Needle):1	 ->Grasp(Right, Needle)
21 Grasp(Right, Needle):0	Grasp(Right, Needle):0	Touch(Right, Needle):1	 ->Grasp(Right, Needle)
22 Grasp(Right, Needle):0	Grasp(Right, Needle):0	Touch(Right, Needle):1	 ->Grasp(Right, Needle)
23 Grasp(Right, Needle):0	Grasp(Right, Needle):0	Touch(Right, Needle):1	 ->Grasp(Right, Needle)
24 Grasp(Right, Needle):0	Grasp(Right, Needle):0	Touch(Right, Needle):1	 ->Grasp(Right, Needle)
25 Grasp(Right, Needle):0	Grasp(Right, Needle):0	Touch(Right, Needle):1	 ->Grasp(Right, Needle)
26 Grasp(Right, Needle):0	Grasp(Right, Needle):0	Touch(Right, Needle):1	 ->Grasp(Right, Needle)
27 Grasp(Right, Needle):0	Grasp(Right, Needle):0	Touch(Right, Needle):1	 ->Grasp(Right, Needle)
28 Grasp(Right, Needle):0	Grasp(Right, Needle):0	Touch(Right, Needle):1	 ->Grasp(Right, Needle)
29 Grasp(Right, Needle):0	Grasp(Right, Needle):0	Touch(Right, Needle):1	 ->Grasp(Right, Needle)
30 Grasp(Right, Needle):0	Grasp(Right, Needle):0	Touch(Right, Needle):1	 ->Grasp(Right, Needle)
31 Grasp(Right, Needle):0	Grasp(Right, Needle):0	Touch(Right, Needle):1	 ->Grasp(Right, Needle)
32 Grasp(Right, Needle):0	Grasp(Right, Needle):0	Touch(Right, Needle):1	 ->Grasp(Right, Needle)
33 Grasp(Right, Needle):0	Grasp(Right, Needle):0	Touch(Right, Needle):1	 ->Grasp(Right, Needle)
34 Grasp(Right, Needle):0	Grasp(Right, Needle):0	Touch(Right, Needle):1	 ->Grasp(Right, Needle)
35 Grasp(Right, Needle):0	Grasp(Right, Needle):0	Touch(Right, Needle):1	 ->Grasp(Right, Needle)
36 Grasp(Right, Needle):0	Grasp(Right, Needle):0	Touch(Right, Needle):1	 ->Grasp(Right, Needle)
37 Grasp(Right, Needle):0	Grasp(Right, Needle):0	Touch(Right, Needle):1	 ->Grasp(Right, Needle)
38 Grasp(Right, Needle):0	Grasp(Right, Needle):0	Touch(Right, Needle):1	 ->Grasp(Right, Needle)
39 Grasp(Right, Needle):0	Grasp(Right, Needle):0	Touch(Right, Needle):1	 ->Grasp(Right, Needle)
40 Grasp(Right, Needle):0	Grasp(Right, Needle):0	Touch(Right, Needle):1	 ->Grasp(Right, Needle)
41 Grasp(Right, Needle):0	Grasp(Right, Needle):0	Touch(Right, Needle):1	 ->Grasp(Right, Needle)
42 Grasp(Right, Needle):0	Grasp(Right, Needle):0	Touch(Right, Needle):1	 ->Grasp(Right, Needle)
43 Grasp(Right, Needle):0	Grasp(Right, Needle):0	Touch(Right, Needle):1	 ->Grasp(Right, Needle)
44 Grasp(Right, Needle):0	Grasp(Right, Needle):0	Touch(Right, Needle):1	 ->Grasp(Right, Needle)
45 Grasp(Right, Needle):0	Grasp(Right, Needle):0	Touch(Right, Needle):1	 ->Grasp(Right, Needle)
46 Grasp(Right, Needle):0	Grasp(Right, Needle):0	Touch(Right, Needle):1	 ->Grasp(Right, Needle)
47 Grasp(Right, Needle):0	Grasp(Right, Needle):0	Touch(Right, Needle):1	 ->Grasp(Right, Needle)
48 Grasp(Right, Needle):0	Grasp(Right, Needle):0	Touch(Right, Needle):1	 ->Grasp(Right, Needle)
49 Grasp(Right, Needle):0	Grasp(Right, Needle):0	Touch(Right, Needle):1	 ->Grasp(Right, Needle)
50 Grasp(Right, Needle):0	Grasp(Right, Needle):0	Touch(Right, Needle):1	 ->Grasp(Right, Needle)
51 Grasp(Right, Needle):0	Grasp(Right, Needle):0	Touch(Right, Needle):1	 ->Grasp(Right, Needle)
52 Grasp(Right, Needle):0	Grasp(Right, Needle):0	Touch(Right, Needle):1	 ->Grasp(Right, Needle)
53 Grasp(Right, Needle):0	Grasp(Right, Needle):0	Touch(Right, Needle):1	 ->Grasp(Right, Needle)
54 Grasp(Right, Needle):0	Grasp(Right, Needle):0	Touch(Right, Needle):1	 ->Grasp(Right, Needle)
55 Grasp(Right, Needle):0	Grasp(Right, Needle):0	Touch(Right, Needle):1	 ->Grasp(Right, Needle)
56 Grasp(Right, Needle):0	Grasp(Right, Needle):0	Touch(Right, Needle):1	 ->Grasp(Right, Needle)
57 Grasp(Right, Needle):0	Grasp(Right, Needle):0	Touch(Right, Needle):1	 ->Grasp(Right, Needle)
58 Grasp(Right, Needle):0	Grasp(Right, Needle):0	Touch(Right, Needle):1	 ->Grasp(Right, Needle)
59 Grasp(Right, Needle):0	Grasp(Right, Needle):0	Touch(Right, Needle):1	 ->Grasp(Right, Needle)
60 Grasp(Right, Needle):0	Grasp(Right, Needle):0	Touch(Right, Needle):1	 ->Grasp(Right, Needle)
61 Grasp(Right, Needle):0	Grasp(Right, Needle):0	Touch(Right, Needle):1	 ->Grasp(Right, Needle)
62 Grasp(Right, Needle):0	Grasp(Right, Needle):0	Touch(Right, Needle):1	 ->Grasp(Right, Needle)
63 Grasp(Right, Needle):0	Grasp(Right, Needle):0	Touch(Right, Needle):1	 ->Grasp(Right, Needle)
64 Grasp(Right, Needle):0	Grasp(Right, Needle):0	Touch(Right, Needle):1	 ->Grasp(Right, Needle)
65 Grasp(Right, Needle):0	Grasp(Right, Needle):0	Touch(Right, Needle):1	 ->Grasp(Right, Needle)
66 Grasp(Right, Needle):0	Grasp(Right, Needle):0	Touch(Right, Needle):1	 ->Grasp(Right, Needle)
67 Grasp(Right, Needle):0	Grasp(Right, Needle):0	Touch(Right, Needle):1	 ->Grasp(Right, Needle)
68 Grasp(Right, Needle):0	Grasp(Right, Needle):0	Touch(Right, Needle):1	 ->Grasp(Right, Needle)
69 Grasp(Right, Needle):0	Grasp(Right, Needle):0	Touch(Right, Needle):1	 ->Grasp(Right, Needle)
70 Grasp(Right, Needle):0	Grasp(Right, Needle):0	Touch(Right, Needle):1	 ->Grasp(Right, Needle)
71 Grasp(Right, Needle):0	Grasp(Right, Needle):0	Touch(Right, Needle):1	 ->Grasp(Right, Needle)
72 Grasp(Right, Needle):0	Grasp(Right, Needle):0	Touch(Right, Needle):1	 ->Grasp(Right, Needle)
73 Grasp(Right, Needle):0	Grasp(Right, Needle):0	Touch(Right, Needle):1	 ->Grasp(Right, Needle)
74 Grasp(Right, Needle):0	Grasp(Right, Needle):0	Touch(Right, Needle):1	 ->Grasp(Right, Needle)
75 Grasp(Right, Needle):0	Grasp(Right, Needle):0	Touch(Right, Needle):1	 ->Grasp(Right, Needle)
76 Grasp(Right, Needle):0	Grasp(Right, Needle):0	Grasp(Right, Needle):0	 ->Grasp(Right, Needle)
77 Grasp(Right, Needle):0	Grasp(Right, Needle):0	Grasp(Right, Needle):0	 ->Grasp(Right, Needle)
78 Grasp(Right, Needle):0	Grasp(Right, Needle):0	Grasp(Right, Needle):0	 ->Grasp(Right, Needle)
79 Grasp(Right, Needle):0	Grasp(Right, Needle):0	Grasp(Right, Needle):0	 ->Grasp(Right, Needle)
80 Grasp(Right, Needle):0	Grasp(Right, Needle):0	Grasp(Right, Needle):0	 ->Grasp(Right, Needle)
81 Grasp(Right, Needle):0	Grasp(Right, Needle):0	Grasp(Right, Needle):0	 ->Grasp(Right, Needle)
82 Grasp(Right, Needle):0	Grasp(Right, Needle):0	Grasp(Right, Needle):0	 ->Grasp(Right, Needle)
83 Grasp(Right, Needle):0	Grasp(Right, Needle):0	Grasp(Right, Needle):0	 ->Grasp(Right, Needle)
84 Grasp(Right, Needle):0	Grasp(Right, Needle):0	Grasp(Right, Needle):0	 ->Grasp(Right, Needle)
85 Grasp(Right, Needle):0	Grasp(Right, Needle):0	Grasp(Right, Needle):0	 ->Grasp(Right, Needle)
86 Grasp(Right, Needle):0	Grasp(Right, Needle):0	Grasp(Right, Needle):0	 ->Grasp(Right, Needle)
87 Grasp(Right, Needle):0	Grasp(Right, Needle):0	Release(Right, Needle):2	 ->Grasp(Right, Needle)
88 Grasp(Right, Needle):0	Grasp(Right, Needle):0	Release(Right, Needle):2	 ->Grasp(Right, Needle)
89 Grasp(Right, Needle):0	Grasp(Right, Needle):0	Release(Right, Needle):2	 ->Grasp(Right, Needle)
90 Grasp(Right, Needle):0	Grasp(Right, Needle):0	Release(Right, Needle):2	 ->Grasp(Right, Needle)
91 Grasp(Right, Needle):0	Grasp(Right, Needle):0	Release(Right, Needle):2	 ->Grasp(Right, Needle)
92 Grasp(Right, Needle):0	Grasp(Right, Needle):0	Release(Right, Needle):2	 ->Grasp(Right, Needle)
93 Grasp(Right, Needle):0	Grasp(Right, Needle):0	Release(Right, Needle):2	 ->Grasp(Right, Needle)
94 Grasp(Right, Needle):0	Grasp(Right, Needle):0	Release(Right, Needle):2	 ->Grasp(Right, Needle)
95 Touch(Right, Needle):1	Grasp(Right, Needle):0	Release(Right, Needle):2	 ->Touch(Right, Needle)
96 Touch(Right, Needle):1	Grasp(Right, Needle):0	Release(Right, Needle):2	 ->Touch(Right, Needle)
97 Touch(Right, Needle):1	Grasp(Right, Needle):0	Release(Right, Needle):2	 ->Touch(Right, Needle)
98 Touch(Right, Needle):1	Grasp(Right, Needle):0	Release(Right, Needle):2	 ->Touch(Right, Needle)
99 Touch(Right, Needle):1	Grasp(Right, Needle):0	Release(Right, Needle):2	 ->Touch(Right, Needle)
100 Touch(Right, Needle):1	Grasp(Right, Needle):0	Release(Right, Needle):2	 ->Touch(Right, Needle)
101 Touch(Right, Needle):1	Grasp(Right, Needle):0	Release(Right, Needle):2	 ->Touch(Right, Needle)
102 Touch(Right, Needle):1	Grasp(Right, Needle):0	Release(Right, Needle):2	 ->Touch(Right, Needle)
103 Touch(Right, Needle):1	Grasp(Right, Needle):0	Release(Right, Needle):2	 ->Touch(Right, Needle)
104 Touch(Right, Needle):1	Grasp(Right, Needle):0	Release(Right, Needle):2	 ->Touch(Right, Needle)
105 Touch(Right, Needle):1	Grasp(Right, Needle):0	Release(Right, Needle):2	 ->Touch(Right, Needle)
106 Touch(Right, Needle):1	Grasp(Right, Needle):0	Release(Right, Needle):2	 ->Touch(Right, Needle)
107 Touch(Right, Needle):1	Grasp(Right, Needle):0	Release(Right, Needle):2	 ->Touch(Right, Needle)
108 Touch(Right, Needle):1	Grasp(Right, Needle):0	Release(Right, Needle):2	 ->Touch(Right, Needle)
109 Touch(Right, Needle):1	Grasp(Right, Needle):0	Release(Right, Needle):2	 ->Touch(Right, Needle)
110 Touch(Right, Needle):1	Grasp(Right, Needle):0	Release(Right, Needle):2	 ->Touch(Right, Needle)
111 Touch(Right, Needle):1	Grasp(Right, Needle):0	Release(Right, Needle):2	 ->Touch(Right, Needle)
112 Touch(Right, Needle):1	Grasp(Right, Needle):0	Release(Right, Needle):2	 ->Touch(Right, Needle)
113 Touch(Right, Needle):1	Grasp(Right, Needle):0	Release(Right, Needle):2	 ->Touch(Right, Needle)
114 Touch(Right, Needle):1	Grasp(Right, Needle):0	Release(Right, Needle):2	 ->Touch(Right, Needle)
115 Touch(Right, Needle):1	Grasp(Right, Needle):0	Release(Right, Needle):2	 ->Touch(Right, Needle)
116 Touch(Right, Needle):1	Grasp(Right, Needle):0	Release(Right, Needle):2	 ->Touch(Right, Needle)
117 Touch(Right, Needle):1	Grasp(Right, Needle):0	Release(Right, Needle):2	 ->Touch(Right, Needle)
118 Touch(Right, Needle):1	Grasp(Right, Needle):0	Release(Right, Needle):2	 ->Touch(Right, Needle)
119 Touch(Right, Needle):1	Grasp(Right, Needle):0	Release(Right, Needle):2	 ->Touch(Right, Needle)
120 Touch(Right, Needle):1	Grasp(Right, Needle):0	Release(Right, Needle):2	 ->Touch(Right, Needle)
121 Touch(Right, Needle):1	Grasp(Right, Needle):0	Release(Right, Needle):2	 ->Touch(Right, Needle)
122 Touch(Right, Needle):1	Grasp(Right, Needle):0	Release(Right, Needle):2	 ->Touch(Right, Needle)
123 Touch(Right, Needle):1	Grasp(Right, Needle):0	Release(Right, Needle):2	 ->Touch(Right, Needle)
124 Touch(Right, Needle):1	Grasp(Right, Needle):0	Release(Right, Needle):2	 ->Touch(Right, Needle)
125 Touch(Right, Needle):1	Grasp(Right, Needle):0	Release(Right, Needle):2	 ->Touch(Right, Needle)
126 Touch(Right, Needle):1	Grasp(Right, Needle):0	Release(Right, Needle):2	 ->Touch(Right, Needle)
127 Touch(Right, Needle):1	Grasp(Right, Needle):0	Release(Right, Needle):2	 ->Touch(Right, Needle)
128 Touch(Right, Needle):1	Grasp(Right, Needle):0	Release(Right, Needle):2	 ->Touch(Right, Needle)
129 Touch(Right, Needle):1	Grasp(Right, Needle):0	Release(Right, Needle):2	 ->Touch(Right, Needle)
130 Touch(Right, Needle):1	Grasp(Right, Needle):0	Release(Right, Needle):2	 ->Touch(Right, Needle)
131 Touch(Right, Needle):1	Grasp(Right, Needle):0	Release(Right, Needle):2	 ->Touch(Right, Needle)
132 Touch(Right, Needle):1	Grasp(Right, Needle):0	Release(Right, Needle):2	 ->Touch(Right, Needle)
133 Touch(Right, Needle):1	Grasp(Right, Needle):0	Release(Right, Needle):2	 ->Touch(Right, Needle)
134 Touch(Right, Needle):1	Grasp(Right, Needle):0	Release(Right, Needle):2	 ->Touch(Right, Needle)
135 Touch(Right, Needle):1	Grasp(Right, Needle):0	Release(Right, Needle):2	 ->Touch(Right, Needle)
136 Touch(Right, Needle):1	Grasp(Right, Needle):0	Release(Right, Needle):2	 ->Touch(Right, Needle)
137 Touch(Right, Needle):1	Grasp(Right, Needle):0	Release(Right, Needle):2	 ->Touch(Right, Needle)
138 Touch(Right, Needle):1	Grasp(Right, Needle):0	Release(Right, Needle):2	 ->Touch(Right, Needle)
139 Touch(Right, Needle):1	Grasp(Right, Needle):0	Release(Right, Needle):2	 ->Touch(Right, Needle)
140 Touch(Right, Needle):1	Grasp(Right, Needle):0	Release(Right, Needle):2	 ->Touch(Right, Needle)
141 Touch(Right, Needle):1	Grasp(Right, Needle):0	Release(Right, Needle):2	 ->Touch(Right, Needle)
142 Touch(Right, Needle):1	Grasp(Right, Needle):0	Release(Right, Needle):2	 ->Touch(Right, Needle)
143 Touch(Right, Needle):1	Grasp(Right, Needle):0	Release(Right, Needle):2	 ->Touch(Right, Needle)
144 Touch(Right, Needle):1	Grasp(Right, Needle):0	Release(Right, Needle):2	 ->Touch(Right, Needle)
145 Touch(Right, Needle):1	Grasp(Right, Needle):0	Release(Right, Needle):2	 ->Touch(Right, Needle)
146 Touch(Right, Needle):1	Grasp(Right, Needle):0	Release(Right, Needle):2	 ->Touch(Right, Needle)
147 Touch(Right, Needle):1	Grasp(Right, Needle):0	Release(Right, Needle):2	 ->Touch(Right, Needle)
148 Touch(Right, Needle):1	Grasp(Right, Needle):0	Release(Right, Needle):2	 ->Touch(Right, Needle)
149 Touch(Right, Needle):1	Grasp(Right, Needle):0	Release(Right, Needle):2	 ->Touch(Right, Needle)
150 Touch(Right, Needle):1	Grasp(Right, Needle):0	Release(Right, Needle):2	 ->Touch(Right, Needle)
151 Touch(Right, Needle):1	Grasp(Right, Needle):0	Release(Right, Needle):2	 ->Touch(Right, Needle)
152 Touch(Right, Needle):1	Grasp(Right, Needle):0	Release(Right, Needle):2	 ->Touch(Right, Needle)
153 Touch(Right, Needle):1	Grasp(Right, Needle):0	Release(Right, Needle):2	 ->Touch(Right, Needle)
154 Touch(Right, Needle):1	Grasp(Right, Needle):0	Release(Right, Needle):2	 ->Touch(Right, Needle)
155 Touch(Right, Needle):1	Release(Right, Needle):2	Release(Right, Needle):2	 ->Release(Right, Needle)
156 Touch(Right, Needle):1	Release(Right, Needle):2	Release(Right, Needle):2	 ->Release(Right, Needle)
157 Touch(Right, Needle):1	Release(Right, Needle):2	Untouch(Right, Needle):3	 ->Touch(Right, Needle)
158 Touch(Right, Needle):1	Release(Right, Needle):2	Untouch(Right, Needle):3	 ->Touch(Right, Needle)
159 Touch(Right, Needle):1	Release(Right, Needle):2	Untouch(Right, Needle):3	 ->Touch(Right, Needle)
160 Touch(Right, Needle):1	Release(Right, Needle):2	Untouch(Right, Needle):3	 ->Touch(Right, Needle)
161 Touch(Right, Needle):1	Release(Right, Needle):2	Untouch(Right, Needle):3	 ->Touch(Right, Needle)
162 Touch(Right, Needle):1	Release(Right, Needle):2	Untouch(Right, Needle):3	 ->Touch(Right, Needle)
163 Touch(Right, Needle):1	Release(Right, Needle):2	Untouch(Right, Needle):3	 ->Touch(Right, Needle)
164 Touch(Right, Needle):1	Release(Right, Needle):2	Untouch(Right, Needle):3	 ->Touch(Right, Needle)
165 Touch(Right, Needle):1	Release(Right, Needle):2	Untouch(Right, Needle):3	 ->Touch(Right, Needle)
166 Touch(Right, Needle):1	Release(Right, Needle):2	Untouch(Right, Needle):3	 ->Touch(Right, Needle)
167 Touch(Right, Needle):1	Release(Right, Needle):2	Touch(Right, Needle):1	 ->Touch(Right, Needle)
168 Touch(Right, Needle):1	Release(Right, Needle):2	Touch(Right, Needle):1	 ->Touch(Right, Needle)
169 Touch(Right, Needle):1	Release(Right, Needle):2	Touch(Right, Needle):1	 ->Touch(Right, Needle)
170 Touch(Right, Needle):1	Release(Right, Needle):2	Touch(Right, Needle):1	 ->Touch(Right, Needle)
171 Touch(Right, Needle):1	Release(Right, Needle):2	Touch(Right, Needle):1	 ->Touch(Right, Needle)
172 Touch(Right, Needle):1	Release(Right, Needle):2	Touch(Right, Needle):1	 ->Touch(Right, Needle)
173 Touch(Right, Needle):1	Release(Right, Needle):2	Touch(Right, Needle):1	 ->Touch(Right, Needle)
174 Touch(Right, Needle):1	Release(Right, Needle):2	Touch(Right, Needle):1	 ->Touch(Right, Needle)
175 Touch(Right, Needle):1	Release(Right, Needle):2	Touch(Right, Needle):1	 ->Touch(Right, Needle)
176 Touch(Right, Needle):1	Release(Right, Needle):2	Touch(Right, Needle):1	 ->Touch(Right, Needle)
177 Touch(Right, Needle):1	Release(Right, Needle):2	Touch(Right, Needle):1	 ->Touch(Right, Needle)
178 Touch(Right, Needle):1	Release(Right, Needle):2	Touch(Right, Needle):1	 ->Touch(Right, Needle)
179 Touch(Right, Needle):1	Release(Right, Needle):2	Touch(Right, Needle):1	 ->Touch(Right, Needle)
180 Touch(Right, Needle):1	Release(Right, Needle):2	Touch(Right, Needle):1	 ->Touch(Right, Needle)
181 Touch(Right, Needle):1	Release(Right, Needle):2	Touch(Right, Needle):1	 ->Touch(Right, Needle)
182 Touch(Right, Needle):1	Release(Right, Needle):2	Touch(Right, Needle):1	 ->Touch(Right, Needle)
183 Touch(Right, Needle):1	Release(Right, Needle):2	Touch(Right, Needle):1	 ->Touch(Right, Needle)
184 Touch(Right, Needle):1	Release(Right, Needle):2	Touch(Right, Needle):1	 ->Touch(Right, Needle)
185 Touch(Right, Needle):1	Release(Right, Needle):2	Touch(Right, Needle):1	 ->Touch(Right, Needle)
186 Touch(Right, Needle):1	Release(Right, Needle):2	Touch(Right, Needle):1	 ->Touch(Right, Needle)
187 Touch(Right, Needle):1	Release(Right, Needle):2	Touch(Right, Needle):1	 ->Touch(Right, Needle)
188 Touch(Right, Needle):1	Release(Right, Needle):2	Touch(Right, Needle):1	 ->Touch(Right, Needle)
189 Touch(Right, Needle):1	Release(Right, Needle):2	Touch(Right, Needle):1	 ->Touch(Right, Needle)
190 Touch(Right, Needle):1	Release(Right, Needle):2	Touch(Right, Needle):1	 ->Touch(Right, Needle)
191 Touch(Right, Needle):1	Release(Right, Needle):2	Touch(Right, Needle):1	 ->Touch(Right, Needle)
192 Touch(Right, Needle):1	Release(Right, Needle):2	Touch(Right, Needle):1	 ->Touch(Right, Needle)
193 Touch(Right, Needle):1	Release(Right, Needle):2	Touch(Right, Needle):1	 ->Touch(Right, Needle)
194 Touch(Right, Needle):1	Release(Right, Needle):2	Touch(Right, Needle):1	 ->Touch(Right, Needle)
195 Touch(Right, Needle):1	Release(Right, Needle):2	Touch(Right, Needle):1	 ->Touch(Right, Needle)
196 Touch(Right, Needle):1	Release(Right, Needle):2	Touch(Right, Needle):1	 ->Touch(Right, Needle)
197 Touch(Right, Needle):1	Release(Right, Needle):2	Touch(Right, Needle):1	 ->Touch(Right, Needle)
198 Touch(Right, Needle):1	Release(Right, Needle):2	Touch(Right, Needle):1	 ->Touch(Right, Needle)
199 Touch(Right, Needle):1	Release(Right, Needle):2	Touch(Right, Needle):1	 ->Touch(Right, Needle)
200 Touch(Right, Needle):1	Release(Right, Needle):2	Touch(Right, Needle):1	 ->Touch(Right, Needle)
201 Touch(Right, Needle):1	Release(Right, Needle):2	Grasp(Right, Needle):0	 ->Touch(Right, Needle)
202 Touch(Right, Needle):1	Release(Right, Needle):2	Grasp(Right, Needle):0	 ->Touch(Right, Needle)
203 Touch(Right, Needle):1	Release(Right, Needle):2	Grasp(Right, Needle):0	 ->Touch(Right, Needle)
204 Touch(Right, Needle):1	Release(Right, Needle):2	Grasp(Right, Needle):0	 ->Touch(Right, Needle)
205 Touch(Right, Needle):1	Release(Right, Needle):2	Grasp(Right, Needle):0	 ->Touch(Right, Needle)
206 Touch(Right, Needle):1	Release(Right, Needle):2	Grasp(Right, Needle):0	 ->Touch(Right, Needle)
207 Grasp(Right, Needle):0	Release(Right, Needle):2	Grasp(Right, Needle):0	 ->Grasp(Right, Needle)
208 Grasp(Right, Needle):0	Release(Right, Needle):2	Grasp(Right, Needle):0	 ->Grasp(Right, Needle)
209 Grasp(Right, Needle):0	Release(Right, Needle):2	Grasp(Right, Needle):0	 ->Grasp(Right, Needle)
210 Grasp(Right, Needle):0	Release(Right, Needle):2	Grasp(Right, Needle):0	 ->Grasp(Right, Needle)
211 Grasp(Right, Needle):0	Release(Right, Needle):2	Touch(Left, Needle):4	 ->Grasp(Right, Needle)
212 Grasp(Right, Needle):0	Release(Right, Needle):2	Touch(Left, Needle):4	 ->Grasp(Right, Needle)
213 Grasp(Right, Needle):0	Release(Right, Needle):2	Touch(Left, Needle):4	 ->Grasp(Right, Needle)
214 Grasp(Right, Needle):0	Release(Right, Needle):2	Touch(Left, Needle):4	 ->Grasp(Right, Needle)
215 Grasp(Right, Needle):0	Grasp(Right, Needle):0	Touch(Left, Needle):4	 ->Grasp(Right, Needle)
216 Grasp(Right, Needle):0	Grasp(Right, Needle):0	Touch(Left, Needle):4	 ->Grasp(Right, Needle)
217 Grasp(Right, Needle):0	Grasp(Right, Needle):0	Touch(Left, Needle):4	 ->Grasp(Right, Needle)
218 Grasp(Right, Needle):0	Grasp(Right, Needle):0	Touch(Left, Needle):4	 ->Grasp(Right, Needle)
219 Grasp(Right, Needle):0	Grasp(Right, Needle):0	Touch(Left, Needle):4	 ->Grasp(Right, Needle)
220 Grasp(Right, Needle):0	Grasp(Right, Needle):0	Touch(Left, Needle):4	 ->Grasp(Right, Needle)
221 Grasp(Right, Needle):0	Grasp(Right, Needle):0	Touch(Left, Needle):4	 ->Grasp(Right, Needle)
222 Grasp(Left, Needle):5	Grasp(Right, Needle):0	Touch(Left, Needle):4	 ->Grasp(Left, Needle)
223 Grasp(Left, Needle):5	Grasp(Right, Needle):0	Touch(Left, Needle):4	 ->Grasp(Left, Needle)
224 Grasp(Left, Needle):5	Grasp(Right, Needle):0	Touch(Left, Needle):4	 ->Grasp(Left, Needle)
225 Grasp(Left, Needle):5	Grasp(Right, Needle):0	Touch(Left, Needle):4	 ->Grasp(Left, Needle)
226 Grasp(Left, Needle):5	Grasp(Right, Needle):0	Touch(Left, Needle):4	 ->Grasp(Left, Needle)
227 Grasp(Left, Needle):5	Grasp(Right, Needle):0	Touch(Left, Needle):4	 ->Grasp(Left, Needle)
228 Grasp(Left, Needle):5	Grasp(Right, Needle):0	Touch(Left, Needle):4	 ->Grasp(Left, Needle)
229 Grasp(Left, Needle):5	Grasp(Right, Needle):0	Touch(Left, Needle):4	 ->Grasp(Left, Needle)
230 Grasp(Left, Needle):5	Grasp(Right, Needle):0	Touch(Left, Needle):4	 ->Grasp(Left, Needle)
231 Grasp(Left, Needle):5	Grasp(Right, Needle):0	Touch(Left, Needle):4	 ->Grasp(Left, Needle)
232 Grasp(Left, Needle):5	Grasp(Right, Needle):0	Touch(Left, Needle):4	 ->Grasp(Left, Needle)
233 Grasp(Left, Needle):5	Grasp(Right, Needle):0	Touch(Left, Needle):4	 ->Grasp(Left, Needle)
234 Grasp(Left, Needle):5	Grasp(Right, Needle):0	Touch(Left, Needle):4	 ->Grasp(Left, Needle)
235 Grasp(Left, Needle):5	Grasp(Right, Needle):0	Touch(Left, Needle):4	 ->Grasp(Left, Needle)
236 Grasp(Left, Needle):5	Grasp(Right, Needle):0	Touch(Left, Needle):4	 ->Grasp(Left, Needle)
237 Grasp(Left, Needle):5	Grasp(Right, Needle):0	Touch(Left, Needle):4	 ->Grasp(Left, Needle)
238 Grasp(Left, Needle):5	Grasp(Right, Needle):0	Touch(Left, Needle):4	 ->Grasp(Left, Needle)
239 Grasp(Left, Needle):5	Grasp(Right, Needle):0	Touch(Left, Needle):4	 ->Grasp(Left, Needle)
240 Grasp(Left, Needle):5	Grasp(Right, Needle):0	Touch(Left, Needle):4	 ->Grasp(Left, Needle)
241 Grasp(Left, Needle):5	Grasp(Right, Needle):0	Touch(Left, Needle):4	 ->Grasp(Left, Needle)
242 Grasp(Left, Needle):5	Grasp(Right, Needle):0	Touch(Left, Needle):4	 ->Grasp(Left, Needle)
243 Grasp(Left, Needle):5	Grasp(Right, Needle):0	Touch(Left, Needle):4	 ->Grasp(Left, Needle)
244 Grasp(Left, Needle):5	Grasp(Right, Needle):0	Touch(Left, Needle):4	 ->Grasp(Left, Needle)
245 Grasp(Left, Needle):5	Grasp(Right, Needle):0	Touch(Left, Needle):4	 ->Grasp(Left, Needle)
246 Grasp(Left, Needle):5	Grasp(Right, Needle):0	Touch(Left, Needle):4	 ->Grasp(Left, Needle)
247 Grasp(Left, Needle):5	Grasp(Right, Needle):0	Touch(Left, Needle):4	 ->Grasp(Left, Needle)
248 Grasp(Left, Needle):5	Grasp(Right, Needle):0	Touch(Left, Needle):4	 ->Grasp(Left, Needle)
249 Grasp(Left, Needle):5	Grasp(Right, Needle):0	Touch(Left, Needle):4	 ->Grasp(Left, Needle)
250 Grasp(Left, Needle):5	Grasp(Right, Needle):0	Touch(Left, Needle):4	 ->Grasp(Left, Needle)
251 Grasp(Left, Needle):5	Grasp(Right, Needle):0	Touch(Left, Needle):4	 ->Grasp(Left, Needle)
252 Grasp(Left, Needle):5	Grasp(Right, Needle):0	Touch(Left, Needle):4	 ->Grasp(Left, Needle)
253 Grasp(Left, Needle):5	Grasp(Right, Needle):0	Touch(Left, Needle):4	 ->Grasp(Left, Needle)
254 Grasp(Left, Needle):5	Grasp(Right, Needle):0	Touch(Left, Needle):4	 ->Grasp(Left, Needle)
255 Grasp(Left, Needle):5	Grasp(Right, Needle):0	Touch(Left, Needle):4	 ->Grasp(Left, Needle)
256 Grasp(Left, Needle):5	Grasp(Right, Needle):0	Touch(Left, Needle):4	 ->Grasp(Left, Needle)
257 Grasp(Left, Needle):5	Grasp(Right, Needle):0	Touch(Left, Needle):4	 ->Grasp(Left, Needle)
258 Grasp(Left, Needle):5	Grasp(Right, Needle):0	Touch(Left, Needle):4	 ->Grasp(Left, Needle)
259 Grasp(Left, Needle):5	Grasp(Right, Needle):0	Touch(Left, Needle):4	 ->Grasp(Left, Needle)
260 Grasp(Left, Needle):5	Grasp(Right, Needle):0	Touch(Left, Needle):4	 ->Grasp(Left, Needle)
261 Grasp(Left, Needle):5	Grasp(Right, Needle):0	Touch(Left, Needle):4	 ->Grasp(Left, Needle)
262 Grasp(Left, Needle):5	Grasp(Right, Needle):0	Touch(Left, Needle):4	 ->Grasp(Left, Needle)
263 Grasp(Left, Needle):5	Grasp(Right, Needle):0	Touch(Left, Needle):4	 ->Grasp(Left, Needle)
264 Grasp(Left, Needle):5	Grasp(Right, Needle):0	Touch(Left, Needle):4	 ->Grasp(Left, Needle)
265 Grasp(Left, Needle):5	Grasp(Right, Needle):0	Touch(Left, Needle):4	 ->Grasp(Left, Needle)
266 Grasp(Left, Needle):5	Grasp(Right, Needle):0	Touch(Left, Needle):4	 ->Grasp(Left, Needle)
267 Grasp(Left, Needle):5	Grasp(Right, Needle):0	Touch(Left, Needle):4	 ->Grasp(Left, Needle)
268 Grasp(Left, Needle):5	Grasp(Right, Needle):0	Touch(Left, Needle):4	 ->Grasp(Left, Needle)
269 Grasp(Left, Needle):5	Grasp(Right, Needle):0	Touch(Left, Needle):4	 ->Grasp(Left, Needle)
270 Grasp(Left, Needle):5	Grasp(Right, Needle):0	Touch(Left, Needle):4	 ->Grasp(Left, Needle)
271 Grasp(Left, Needle):5	Grasp(Right, Needle):0	Touch(Left, Needle):4	 ->Grasp(Left, Needle)
272 Grasp(Left, Needle):5	Grasp(Right, Needle):0	Touch(Left, Needle):4	 ->Grasp(Left, Needle)
273 Grasp(Left, Needle):5	Grasp(Right, Needle):0	Touch(Left, Needle):4	 ->Grasp(Left, Needle)
274 Grasp(Left, Needle):5	Grasp(Right, Needle):0	Touch(Left, Needle):4	 ->Grasp(Left, Needle)
275 Grasp(Left, Needle):5	Grasp(Right, Needle):0	Touch(Left, Needle):4	 ->Grasp(Left, Needle)
276 Grasp(Left, Needle):5	Grasp(Right, Needle):0	Touch(Left, Needle):4	 ->Grasp(Left, Needle)
277 Grasp(Left, Needle):5	Grasp(Right, Needle):0	Touch(Left, Needle):4	 ->Grasp(Left, Needle)
278 Grasp(Left, Needle):5	Grasp(Right, Needle):0	Touch(Left, Needle):4	 ->Grasp(Left, Needle)
279 Grasp(Left, Needle):5	Grasp(Right, Needle):0	Touch(Left, Needle):4	 ->Grasp(Left, Needle)
280 Grasp(Left, Needle):5	Grasp(Right, Needle):0	Touch(Left, Needle):4	 ->Grasp(Left, Needle)
281 Grasp(Left, Needle):5	Grasp(Right, Needle):0	Touch(Left, Needle):4	 ->Grasp(Left, Needle)
282 Grasp(Left, Needle):5	Grasp(Right, Needle):0	Touch(Left, Needle):4	 ->Grasp(Left, Needle)
283 Grasp(Left, Needle):5	Grasp(Right, Needle):0	Touch(Left, Needle):4	 ->Grasp(Left, Needle)
284 Grasp(Left, Needle):5	Grasp(Right, Needle):0	Touch(Left, Needle):4	 ->Grasp(Left, Needle)
285 Grasp(Left, Needle):5	Grasp(Right, Needle):0	Touch(Left, Needle):4	 ->Grasp(Left, Needle)
286 Grasp(Left, Needle):5	Grasp(Right, Needle):0	Touch(Left, Needle):4	 ->Grasp(Left, Needle)
287 Grasp(Left, Needle):5	Grasp(Right, Needle):0	Touch(Left, Needle):4	 ->Grasp(Left, Needle)
288 Grasp(Left, Needle):5	Grasp(Right, Needle):0	Touch(Left, Needle):4	 ->Grasp(Left, Needle)
289 Grasp(Left, Needle):5	Grasp(Right, Needle):0	Touch(Left, Needle):4	 ->Grasp(Left, Needle)
290 Grasp(Left, Needle):5	Grasp(Right, Needle):0	Touch(Left, Needle):4	 ->Grasp(Left, Needle)
291 Grasp(Left, Needle):5	Grasp(Right, Needle):0	Touch(Left, Needle):4	 ->Grasp(Left, Needle)
292 Grasp(Left, Needle):5	Grasp(Right, Needle):0	Touch(Left, Needle):4	 ->Grasp(Left, Needle)
293 Grasp(Left, Needle):5	Grasp(Right, Needle):0	Touch(Left, Needle):4	 ->Grasp(Left, Needle)
294 Grasp(Left, Needle):5	Grasp(Right, Needle):0	Touch(Left, Needle):4	 ->Grasp(Left, Needle)
295 Grasp(Left, Needle):5	Grasp(Right, Needle):0	Touch(Left, Needle):4	 ->Grasp(Left, Needle)
296 Grasp(Left, Needle):5	Grasp(Right, Needle):0	Touch(Left, Needle):4	 ->Grasp(Left, Needle)
297 Grasp(Left, Needle):5	Grasp(Right, Needle):0	Touch(Left, Needle):4	 ->Grasp(Left, Needle)
298 Grasp(Left, Needle):5	Grasp(Right, Needle):0	Touch(Left, Needle):4	 ->Grasp(Left, Needle)
299 Grasp(Left, Needle):5	Grasp(Right, Needle):0	Touch(Left, Needle):4	 ->Grasp(Left, Needle)
300 Grasp(Left, Needle):5	Grasp(Right, Needle):0	Touch(Left, Needle):4	 ->Grasp(Left, Needle)
301 Grasp(Left, Needle):5	Grasp(Right, Needle):0	Touch(Left, Needle):4	 ->Grasp(Left, Needle)
302 Grasp(Left, Needle):5	Grasp(Right, Needle):0	Touch(Left, Needle):4	 ->Grasp(Left, Needle)
303 Grasp(Left, Needle):5	Grasp(Right, Needle):0	Touch(Left, Needle):4	 ->Grasp(Left, Needle)
304 Grasp(Left, Needle):5	Grasp(Right, Needle):0	Touch(Left, Needle):4	 ->Grasp(Left, Needle)
305 Grasp(Left, Needle):5	Grasp(Right, Needle):0	Touch(Left, Needle):4	 ->Grasp(Left, Needle)
306 Grasp(Left, Needle):5	Grasp(Right, Needle):0	Touch(Left, Needle):4	 ->Grasp(Left, Needle)
307 Grasp(Left, Needle):5	Grasp(Right, Needle):0	Touch(Left, Needle):4	 ->Grasp(Left, Needle)
308 Grasp(Left, Needle):5	Grasp(Right, Needle):0	Touch(Left, Needle):4	 ->Grasp(Left, Needle)
309 Grasp(Left, Needle):5	Grasp(Right, Needle):0	Touch(Left, Needle):4	 ->Grasp(Left, Needle)
310 Grasp(Left, Needle):5	Grasp(Right, Needle):0	Touch(Left, Needle):4	 ->Grasp(Left, Needle)
311 Grasp(Left, Needle):5	Grasp(Right, Needle):0	Touch(Left, Needle):4	 ->Grasp(Left, Needle)
312 Grasp(Left, Needle):5	Grasp(Right, Needle):0	Touch(Left, Needle):4	 ->Grasp(Left, Needle)
313 Grasp(Left, Needle):5	Grasp(Right, Needle):0	Touch(Left, Needle):4	 ->Grasp(Left, Needle)
314 Grasp(Left, Needle):5	Grasp(Right, Needle):0	Touch(Left, Needle):4	 ->Grasp(Left, Needle)
315 Grasp(Left, Needle):5	Grasp(Right, Needle):0	Touch(Left, Needle):4	 ->Grasp(Left, Needle)
316 Grasp(Left, Needle):5	Grasp(Right, Needle):0	Touch(Left, Needle):4	 ->Grasp(Left, Needle)
317 Grasp(Left, Needle):5	Grasp(Right, Needle):0	Touch(Left, Needle):4	 ->Grasp(Left, Needle)
318 Grasp(Left, Needle):5	Grasp(Right, Needle):0	Touch(Left, Needle):4	 ->Grasp(Left, Needle)
319 Grasp(Left, Needle):5	Grasp(Right, Needle):0	Touch(Left, Needle):4	 ->Grasp(Left, Needle)
320 Grasp(Left, Needle):5	Grasp(Right, Needle):0	Touch(Left, Needle):4	 ->Grasp(Left, Needle)
321 Grasp(Left, Needle):5	Grasp(Right, Needle):0	Touch(Left, Needle):4	 ->Grasp(Left, Needle)
322 Grasp(Left, Needle):5	Grasp(Right, Needle):0	Touch(Left, Needle):4	 ->Grasp(Left, Needle)
323 Grasp(Left, Needle):5	Grasp(Right, Needle):0	Touch(Left, Needle):4	 ->Grasp(Left, Needle)
324 Grasp(Left, Needle):5	Grasp(Right, Needle):0	Touch(Left, Needle):4	 ->Grasp(Left, Needle)
325 Grasp(Left, Needle):5	Grasp(Right, Needle):0	Touch(Left, Needle):4	 ->Grasp(Left, Needle)
326 Grasp(Left, Needle):5	Grasp(Right, Needle):0	Touch(Left, Needle):4	 ->Grasp(Left, Needle)
327 Grasp(Left, Needle):5	Grasp(Right, Needle):0	Touch(Left, Needle):4	 ->Grasp(Left, Needle)
328 Grasp(Left, Needle):5	Grasp(Right, Needle):0	Touch(Left, Needle):4	 ->Grasp(Left, Needle)
329 Grasp(Left, Needle):5	Grasp(Right, Needle):0	Touch(Left, Needle):4	 ->Grasp(Left, Needle)
330 Grasp(Left, Needle):5	Grasp(Right, Needle):0	Touch(Left, Needle):4	 ->Grasp(Left, Needle)
331 Grasp(Left, Needle):5	Grasp(Right, Needle):0	Touch(Left, Needle):4	 ->Grasp(Left, Needle)
332 Grasp(Left, Needle):5	Grasp(Right, Needle):0	Touch(Left, Needle):4	 ->Grasp(Left, Needle)
333 Grasp(Left, Needle):5	Grasp(Right, Needle):0	Touch(Left, Needle):4	 ->Grasp(Left, Needle)
334 Grasp(Left, Needle):5	Grasp(Right, Needle):0	Touch(Left, Needle):4	 ->Grasp(Left, Needle)
335 Grasp(Left, Needle):5	Grasp(Right, Needle):0	Touch(Left, Needle):4	 ->Grasp(Left, Needle)
336 Grasp(Left, Needle):5	Grasp(Right, Needle):0	Touch(Left, Needle):4	 ->Grasp(Left, Needle)
337 Grasp(Left, Needle):5	Grasp(Right, Needle):0	Touch(Left, Needle):4	 ->Grasp(Left, Needle)
338 Grasp(Left, Needle):5	Grasp(Right, Needle):0	Touch(Left, Needle):4	 ->Grasp(Left, Needle)
339 Grasp(Left, Needle):5	Grasp(Right, Needle):0	Touch(Left, Needle):4	 ->Grasp(Left, Needle)
340 Grasp(Left, Needle):5	Grasp(Right, Needle):0	Touch(Left, Needle):4	 ->Grasp(Left, Needle)
341 Grasp(Left, Needle):5	Grasp(Right, Needle):0	Touch(Left, Needle):4	 ->Grasp(Left, Needle)
342 Grasp(Left, Needle):5	Grasp(Right, Needle):0	Touch(Left, Needle):4	 ->Grasp(Left, Needle)
343 Grasp(Left, Needle):5	Grasp(Right, Needle):0	Touch(Left, Needle):4	 ->Grasp(Left, Needle)
344 Grasp(Left, Needle):5	Grasp(Right, Needle):0	Touch(Left, Needle):4	 ->Grasp(Left, Needle)
345 Grasp(Left, Needle):5	Grasp(Right, Needle):0	Touch(Left, Needle):4	 ->Grasp(Left, Needle)
346 Grasp(Left, Needle):5	Grasp(Right, Needle):0	Touch(Left, Needle):4	 ->Grasp(Left, Needle)
347 Grasp(Left, Needle):5	Grasp(Right, Needle):0	Touch(Left, Needle):4	 ->Grasp(Left, Needle)
348 Grasp(Left, Needle):5	Grasp(Right, Needle):0	Touch(Left, Needle):4	 ->Grasp(Left, Needle)
349 Grasp(Left, Needle):5	Grasp(Right, Needle):0	Touch(Left, Needle):4	 ->Grasp(Left, Needle)
350 Grasp(Left, Needle):5	Grasp(Right, Needle):0	Touch(Left, Needle):4	 ->Grasp(Left, Needle)
351 Grasp(Left, Needle):5	Grasp(Right, Needle):0	Touch(Left, Needle):4	 ->Grasp(Left, Needle)
352 Grasp(Left, Needle):5	Grasp(Right, Needle):0	Touch(Left, Needle):4	 ->Grasp(Left, Needle)
353 Grasp(Left, Needle):5	Grasp(Right, Needle):0	Touch(Left, Needle):4	 ->Grasp(Left, Needle)
354 Grasp(Left, Needle):5	Grasp(Right, Needle):0	Touch(Left, Needle):4	 ->Grasp(Left, Needle)
355 Grasp(Left, Needle):5	Grasp(Right, Needle):0	Touch(Left, Needle):4	 ->Grasp(Left, Needle)
356 Grasp(Left, Needle):5	Grasp(Right, Needle):0	Grasp(Left, Needle):5	 ->Grasp(Left, Needle)
357 Grasp(Left, Needle):5	Grasp(Right, Needle):0	Grasp(Left, Needle):5	 ->Grasp(Left, Needle)
358 Grasp(Left, Needle):5	Grasp(Right, Needle):0	Grasp(Left, Needle):5	 ->Grasp(Left, Needle)
359 Grasp(Left, Needle):5	Grasp(Right, Needle):0	Grasp(Left, Needle):5	 ->Grasp(Left, Needle)
360 Grasp(Left, Needle):5	Grasp(Right, Needle):0	Grasp(Left, Needle):5	 ->Grasp(Left, Needle)
361 Grasp(Left, Needle):5	Grasp(Right, Needle):0	Grasp(Left, Needle):5	 ->Grasp(Left, Needle)
362 Grasp(Left, Needle):5	Grasp(Right, Needle):0	Grasp(Left, Needle):5	 ->Grasp(Left, Needle)
363 Grasp(Left, Needle):5	Grasp(Right, Needle):0	Grasp(Left, Needle):5	 ->Grasp(Left, Needle)
364 Grasp(Left, Needle):5	Grasp(Right, Needle):0	Grasp(Left, Needle):5	 ->Grasp(Left, Needle)
365 Grasp(Left, Needle):5	Grasp(Right, Needle):0	Grasp(Left, Needle):5	 ->Grasp(Left, Needle)
366 Grasp(Left, Needle):5	Grasp(Right, Needle):0	Grasp(Left, Needle):5	 ->Grasp(Left, Needle)
367 Grasp(Left, Needle):5	Grasp(Right, Needle):0	Grasp(Left, Needle):5	 ->Grasp(Left, Needle)
368 Grasp(Left, Needle):5	Grasp(Right, Needle):0	Grasp(Left, Needle):5	 ->Grasp(Left, Needle)
369 Grasp(Left, Needle):5	Grasp(Right, Needle):0	Grasp(Left, Needle):5	 ->Grasp(Left, Needle)
370 Grasp(Left, Needle):5	Grasp(Right, Needle):0	Grasp(Left, Needle):5	 ->Grasp(Left, Needle)
371 Grasp(Left, Needle):5	Grasp(Right, Needle):0	Grasp(Left, Needle):5	 ->Grasp(Left, Needle)
372 Grasp(Left, Needle):5	Grasp(Right, Needle):0	Grasp(Left, Needle):5	 ->Grasp(Left, Needle)
373 Grasp(Left, Needle):5	Grasp(Right, Needle):0	Grasp(Left, Needle):5	 ->Grasp(Left, Needle)
374 Grasp(Left, Needle):5	Grasp(Right, Needle):0	Grasp(Left, Needle):5	 ->Grasp(Left, Needle)
375 Grasp(Left, Needle):5	Grasp(Right, Needle):0	Grasp(Left, Needle):5	 ->Grasp(Left, Needle)
376 Grasp(Left, Needle):5	Grasp(Right, Needle):0	Grasp(Left, Needle):5	 ->Grasp(Left, Needle)
377 Grasp(Left, Needle):5	Grasp(Right, Needle):0	Grasp(Left, Needle):5	 ->Grasp(Left, Needle)
378 Grasp(Left, Needle):5	Grasp(Right, Needle):0	Grasp(Left, Needle):5	 ->Grasp(Left, Needle)
379 Grasp(Left, Needle):5	Grasp(Right, Needle):0	Grasp(Left, Needle):5	 ->Grasp(Left, Needle)
380 Grasp(Left, Needle):5	Grasp(Right, Needle):0	Grasp(Left, Needle):5	 ->Grasp(Left, Needle)
381 Grasp(Left, Needle):5	Grasp(Right, Needle):0	Grasp(Left, Needle):5	 ->Grasp(Left, Needle)
382 Grasp(Left, Needle):5	Grasp(Right, Needle):0	Grasp(Left, Needle):5	 ->Grasp(Left, Needle)
383 Grasp(Left, Needle):5	Grasp(Right, Needle):0	Grasp(Left, Needle):5	 ->Grasp(Left, Needle)
384 Grasp(Left, Needle):5	Grasp(Right, Needle):0	Grasp(Left, Needle):5	 ->Grasp(Left, Needle)
385 Grasp(Left, Needle):5	Grasp(Right, Needle):0	Grasp(Left, Needle):5	 ->Grasp(Left, Needle)
386 Grasp(Left, Needle):5	Grasp(Right, Needle):0	Grasp(Left, Needle):5	 ->Grasp(Left, Needle)
387 Grasp(Left, Needle):5	Grasp(Left, Needle):5	Grasp(Left, Needle):5	 ->Grasp(Left, Needle)
388 Grasp(Left, Needle):5	Grasp(Left, Needle):5	Grasp(Left, Needle):5	 ->Grasp(Left, Needle)
389 Grasp(Left, Needle):5	Grasp(Left, Needle):5	Release(Right, Needle):2	 ->Grasp(Left, Needle)
390 Grasp(Left, Needle):5	Grasp(Left, Needle):5	Release(Right, Needle):2	 ->Grasp(Left, Needle)
391 Grasp(Right, Needle):0	Grasp(Left, Needle):5	Release(Right, Needle):2	 ->Grasp(Right, Needle)
392 Grasp(Right, Needle):0	Grasp(Left, Needle):5	Release(Right, Needle):2	 ->Grasp(Right, Needle)
393 Grasp(Right, Needle):0	Grasp(Left, Needle):5	Release(Right, Needle):2	 ->Grasp(Right, Needle)
394 Grasp(Right, Needle):0	Grasp(Left, Needle):5	Release(Right, Needle):2	 ->Grasp(Right, Needle)
395 Grasp(Right, Needle):0	Grasp(Left, Needle):5	Release(Right, Needle):2	 ->Grasp(Right, Needle)
396 Grasp(Right, Needle):0	Grasp(Left, Needle):5	Release(Right, Needle):2	 ->Grasp(Right, Needle)
397 Grasp(Right, Needle):0	Grasp(Left, Needle):5	Release(Right, Needle):2	 ->Grasp(Right, Needle)
398 Grasp(Right, Needle):0	Grasp(Left, Needle):5	Release(Right, Needle):2	 ->Grasp(Right, Needle)
399 Grasp(Right, Needle):0	Grasp(Left, Needle):5	Release(Right, Needle):2	 ->Grasp(Right, Needle)
400 Grasp(Right, Needle):0	Grasp(Left, Needle):5	Release(Right, Needle):2	 ->Grasp(Right, Needle)
401 Grasp(Right, Needle):0	Grasp(Left, Needle):5	Release(Right, Needle):2	 ->Grasp(Right, Needle)
402 Grasp(Right, Needle):0	Release(Right, Needle):2	Untouch(Right, Needle):3	 ->Grasp(Right, Needle)
403 Grasp(Right, Needle):0	Release(Right, Needle):2	Untouch(Right, Needle):3	 ->Grasp(Right, Needle)
404 Grasp(Right, Needle):0	Release(Right, Needle):2	Untouch(Right, Needle):3	 ->Grasp(Right, Needle)
405 Grasp(Right, Needle):0	Release(Right, Needle):2	Untouch(Right, Needle):3	 ->Grasp(Right, Needle)
406 Grasp(Right, Needle):0	Release(Right, Needle):2	Untouch(Right, Needle):3	 ->Grasp(Right, Needle)
407 Grasp(Right, Needle):0	Release(Right, Needle):2	Untouch(Right, Needle):3	 ->Grasp(Right, Needle)
408 Grasp(Right, Needle):0	Release(Right, Needle):2	Untouch(Right, Needle):3	 ->Grasp(Right, Needle)
409 Grasp(Right, Needle):0	Release(Right, Needle):2	Untouch(Right, Needle):3	 ->Grasp(Right, Needle)
410 Grasp(Right, Needle):0	Release(Right, Needle):2	Untouch(Right, Needle):3	 ->Grasp(Right, Needle)
411 Grasp(Right, Needle):0	Release(Right, Needle):2	Untouch(Right, Needle):3	 ->Grasp(Right, Needle)
412 Grasp(Right, Needle):0	Release(Right, Needle):2	Untouch(Right, Needle):3	 ->Grasp(Right, Needle)
413 Grasp(Right, Needle):0	Release(Right, Needle):2	Untouch(Right, Needle):3	 ->Grasp(Right, Needle)
414 Grasp(Right, Needle):0	Release(Right, Needle):2	Untouch(Right, Needle):3	 ->Grasp(Right, Needle)
415 Grasp(Right, Needle):0	Release(Right, Needle):2	Touch(Right, Needle):1	 ->Grasp(Right, Needle)
416 Grasp(Right, Needle):0	Release(Right, Needle):2	Touch(Right, Needle):1	 ->Grasp(Right, Needle)
417 Grasp(Right, Needle):0	Release(Right, Needle):2	Touch(Right, Needle):1	 ->Grasp(Right, Needle)
418 Grasp(Right, Needle):0	Release(Right, Needle):2	Touch(Right, Needle):1	 ->Grasp(Right, Needle)
419 Grasp(Right, Needle):0	Release(Right, Needle):2	Touch(Right, Needle):1	 ->Grasp(Right, Needle)
420 Grasp(Right, Needle):0	Release(Right, Needle):2	Touch(Right, Needle):1	 ->Grasp(Right, Needle)
421 Grasp(Right, Needle):0	Release(Right, Needle):2	Touch(Right, Needle):1	 ->Grasp(Right, Needle)
422 Grasp(Right, Needle):0	Release(Right, Needle):2	Touch(Right, Needle):1	 ->Grasp(Right, Needle)
423 Grasp(Right, Needle):0	Release(Right, Needle):2	Touch(Right, Needle):1	 ->Grasp(Right, Needle)
424 Grasp(Right, Needle):0	Release(Right, Needle):2	Touch(Right, Needle):1	 ->Grasp(Right, Needle)
425 Grasp(Right, Needle):0	Release(Right, Needle):2	Touch(Right, Needle):1	 ->Grasp(Right, Needle)
426 Grasp(Right, Needle):0	Release(Right, Needle):2	Touch(Right, Needle):1	 ->Grasp(Right, Needle)
427 Grasp(Right, Needle):0	Release(Right, Needle):2	Touch(Right, Needle):1	 ->Grasp(Right, Needle)
428 Grasp(Right, Needle):0	Release(Right, Needle):2	Touch(Right, Needle):1	 ->Grasp(Right, Needle)
429 Grasp(Right, Needle):0	Release(Right, Needle):2	Touch(Right, Needle):1	 ->Grasp(Right, Needle)
430 Grasp(Right, Needle):0	Release(Right, Needle):2	Touch(Right, Needle):1	 ->Grasp(Right, Needle)
431 Grasp(Right, Needle):0	Release(Right, Needle):2	Touch(Right, Needle):1	 ->Grasp(Right, Needle)
432 Grasp(Right, Needle):0	Release(Right, Needle):2	Touch(Right, Needle):1	 ->Grasp(Right, Needle)
433 Grasp(Right, Needle):0	Release(Right, Needle):2	Touch(Right, Needle):1	 ->Grasp(Right, Needle)
434 Grasp(Right, Needle):0	Release(Right, Needle):2	Touch(Right, Needle):1	 ->Grasp(Right, Needle)
435 Grasp(Right, Needle):0	Release(Right, Needle):2	Touch(Right, Needle):1	 ->Grasp(Right, Needle)
436 Grasp(Right, Needle):0	Release(Right, Needle):2	Touch(Right, Needle):1	 ->Grasp(Right, Needle)
437 Grasp(Right, Needle):0	Release(Right, Needle):2	Touch(Right, Needle):1	 ->Grasp(Right, Needle)
438 Grasp(Right, Needle):0	Release(Right, Needle):2	Touch(Right, Needle):1	 ->Grasp(Right, Needle)
439 Grasp(Right, Needle):0	Release(Right, Needle):2	Touch(Right, Needle):1	 ->Grasp(Right, Needle)
440 Grasp(Right, Needle):0	Release(Right, Needle):2	Touch(Right, Needle):1	 ->Grasp(Right, Needle)
441 Grasp(Right, Needle):0	Release(Right, Needle):2	Touch(Right, Needle):1	 ->Grasp(Right, Needle)
442 Grasp(Right, Needle):0	Release(Right, Needle):2	Touch(Right, Needle):1	 ->Grasp(Right, Needle)
443 Grasp(Right, Needle):0	Release(Right, Needle):2	Touch(Right, Needle):1	 ->Grasp(Right, Needle)
444 Grasp(Right, Needle):0	Release(Right, Needle):2	Touch(Right, Needle):1	 ->Grasp(Right, Needle)
445 Grasp(Right, Needle):0	Release(Right, Needle):2	Touch(Right, Needle):1	 ->Grasp(Right, Needle)
446 Grasp(Right, Needle):0	Release(Right, Needle):2	Touch(Right, Needle):1	 ->Grasp(Right, Needle)
447 Grasp(Right, Needle):0	Release(Right, Needle):2	Touch(Right, Needle):1	 ->Grasp(Right, Needle)
448 Grasp(Right, Needle):0	Release(Right, Needle):2	Touch(Right, Needle):1	 ->Grasp(Right, Needle)
449 Grasp(Right, Needle):0	Release(Right, Needle):2	Touch(Right, Needle):1	 ->Grasp(Right, Needle)
450 Grasp(Right, Needle):0	Release(Right, Needle):2	Touch(Right, Needle):1	 ->Grasp(Right, Needle)
451 Grasp(Right, Needle):0	Release(Right, Needle):2	Touch(Right, Needle):1	 ->Grasp(Right, Needle)
452 Grasp(Right, Needle):0	Release(Right, Needle):2	Touch(Right, Needle):1	 ->Grasp(Right, Needle)
453 Grasp(Right, Needle):0	Release(Right, Needle):2	Touch(Right, Needle):1	 ->Grasp(Right, Needle)
454 Grasp(Right, Needle):0	Release(Right, Needle):2	Touch(Right, Needle):1	 ->Grasp(Right, Needle)
455 Grasp(Right, Needle):0	Release(Right, Needle):2	Touch(Right, Needle):1	 ->Grasp(Right, Needle)
456 Grasp(Right, Needle):0	Release(Right, Needle):2	Touch(Right, Needle):1	 ->Grasp(Right, Needle)
457 Grasp(Right, Needle):0	Release(Right, Needle):2	Touch(Right, Needle):1	 ->Grasp(Right, Needle)
458 Grasp(Right, Needle):0	Release(Right, Needle):2	Touch(Right, Needle):1	 ->Grasp(Right, Needle)
459 Grasp(Right, Needle):0	Release(Right, Needle):2	Touch(Right, Needle):1	 ->Grasp(Right, Needle)
460 Grasp(Right, Needle):0	Release(Right, Needle):2	Touch(Right, Needle):1	 ->Grasp(Right, Needle)
461 Grasp(Right, Needle):0	Release(Right, Needle):2	Touch(Right, Needle):1	 ->Grasp(Right, Needle)
462 Grasp(Right, Needle):0	Release(Right, Needle):2	Touch(Right, Needle):1	 ->Grasp(Right, Needle)
463 Grasp(Right, Needle):0	Release(Right, Needle):2	Touch(Right, Needle):1	 ->Grasp(Right, Needle)
464 Grasp(Right, Needle):0	Release(Right, Needle):2	Touch(Right, Needle):1	 ->Grasp(Right, Needle)
465 Grasp(Right, Needle):0	Release(Right, Needle):2	Touch(Right, Needle):1	 ->Grasp(Right, Needle)
466 Grasp(Right, Needle):0	Release(Right, Needle):2	Touch(Right, Needle):1	 ->Grasp(Right, Needle)
467 Grasp(Right, Needle):0	Release(Right, Needle):2	Touch(Right, Needle):1	 ->Grasp(Right, Needle)
468 Grasp(Right, Needle):0	Release(Right, Needle):2	Touch(Right, Needle):1	 ->Grasp(Right, Needle)
469 Grasp(Right, Needle):0	Release(Right, Needle):2	Touch(Right, Needle):1	 ->Grasp(Right, Needle)
470 Grasp(Right, Needle):0	Release(Right, Needle):2	Touch(Right, Needle):1	 ->Grasp(Right, Needle)
471 Grasp(Right, Needle):0	Release(Right, Needle):2	Touch(Right, Needle):1	 ->Grasp(Right, Needle)
472 Grasp(Right, Needle):0	Release(Right, Needle):2	Touch(Right, Needle):1	 ->Grasp(Right, Needle)
473 Grasp(Right, Needle):0	Release(Right, Needle):2	Touch(Right, Needle):1	 ->Grasp(Right, Needle)
474 Grasp(Right, Needle):0	Release(Right, Needle):2	Touch(Right, Needle):1	 ->Grasp(Right, Needle)
475 Grasp(Right, Needle):0	Release(Right, Needle):2	Touch(Right, Needle):1	 ->Grasp(Right, Needle)
476 Grasp(Right, Needle):0	Release(Right, Needle):2	Touch(Right, Needle):1	 ->Grasp(Right, Needle)
477 Grasp(Right, Needle):0	Release(Right, Needle):2	Touch(Right, Needle):1	 ->Grasp(Right, Needle)
478 Grasp(Right, Needle):0	Release(Right, Needle):2	Touch(Right, Needle):1	 ->Grasp(Right, Needle)
479 Grasp(Right, Needle):0	Release(Right, Needle):2	Touch(Right, Needle):1	 ->Grasp(Right, Needle)
480 Grasp(Right, Needle):0	Release(Right, Needle):2	Touch(Right, Needle):1	 ->Grasp(Right, Needle)
481 Grasp(Right, Needle):0	Release(Right, Needle):2	Touch(Right, Needle):1	 ->Grasp(Right, Needle)
482 Grasp(Right, Needle):0	Release(Right, Needle):2	Touch(Right, Needle):1	 ->Grasp(Right, Needle)
483 Grasp(Right, Needle):0	Release(Right, Needle):2	Touch(Right, Needle):1	 ->Grasp(Right, Needle)
484 Grasp(Right, Needle):0	Release(Right, Needle):2	Touch(Right, Needle):1	 ->Grasp(Right, Needle)
485 Grasp(Right, Needle):0	Release(Right, Needle):2	Touch(Right, Needle):1	 ->Grasp(Right, Needle)
486 Grasp(Right, Needle):0	Release(Right, Needle):2	Touch(Right, Needle):1	 ->Grasp(Right, Needle)
487 Grasp(Right, Needle):0	Release(Right, Needle):2	Touch(Right, Needle):1	 ->Grasp(Right, Needle)
488 Grasp(Right, Needle):0	Release(Right, Needle):2	Touch(Right, Needle):1	 ->Grasp(Right, Needle)
489 Grasp(Right, Needle):0	Release(Right, Needle):2	Touch(Right, Needle):1	 ->Grasp(Right, Needle)
490 Grasp(Right, Needle):0	Release(Right, Needle):2	Touch(Right, Needle):1	 ->Grasp(Right, Needle)
491 Grasp(Right, Needle):0	Release(Right, Needle):2	Touch(Right, Needle):1	 ->Grasp(Right, Needle)
492 Grasp(Right, Needle):0	Release(Right, Needle):2	Touch(Right, Needle):1	 ->Grasp(Right, Needle)
493 Grasp(Right, Needle):0	Release(Right, Needle):2	Touch(Right, Needle):1	 ->Grasp(Right, Needle)
494 Grasp(Right, Needle):0	Release(Right, Needle):2	Touch(Right, Needle):1	 ->Grasp(Right, Needle)
495 Grasp(Right, Needle):0	Release(Right, Needle):2	Touch(Right, Needle):1	 ->Grasp(Right, Needle)
496 Grasp(Right, Needle):0	Release(Right, Needle):2	Touch(Right, Needle):1	 ->Grasp(Right, Needle)
497 Grasp(Right, Needle):0	Release(Right, Needle):2	Touch(Right, Needle):1	 ->Grasp(Right, Needle)
498 Grasp(Right, Needle):0	Release(Right, Needle):2	Touch(Right, Needle):1	 ->Grasp(Right, Needle)
499 Grasp(Right, Needle):0	Release(Right, Needle):2	Touch(Right, Needle):1	 ->Grasp(Right, Needle)
500 Grasp(Right, Needle):0	Release(Right, Needle):2	Touch(Right, Needle):1	 ->Grasp(Right, Needle)
501 Grasp(Right, Needle):0	Release(Right, Needle):2	Touch(Right, Needle):1	 ->Grasp(Right, Needle)
502 Grasp(Right, Needle):0	Release(Right, Needle):2	Touch(Right, Needle):1	 ->Grasp(Right, Needle)
503 Grasp(Right, Needle):0	Release(Right, Needle):2	Touch(Right, Needle):1	 ->Grasp(Right, Needle)
504 Grasp(Right, Needle):0	Release(Right, Needle):2	Touch(Right, Needle):1	 ->Grasp(Right, Needle)
505 Grasp(Right, Needle):0	Release(Right, Needle):2	Touch(Right, Needle):1	 ->Grasp(Right, Needle)
506 Grasp(Right, Needle):0	Release(Right, Needle):2	Touch(Right, Needle):1	 ->Grasp(Right, Needle)
507 Grasp(Right, Needle):0	Release(Right, Needle):2	Touch(Right, Needle):1	 ->Grasp(Right, Needle)
508 Grasp(Right, Needle):0	Release(Right, Needle):2	Touch(Right, Needle):1	 ->Grasp(Right, Needle)
509 Grasp(Right, Needle):0	Release(Right, Needle):2	Touch(Right, Needle):1	 ->Grasp(Right, Needle)
510 Grasp(Right, Needle):0	Release(Right, Needle):2	Touch(Right, Needle):1	 ->Grasp(Right, Needle)
511 Grasp(Right, Needle):0	Release(Right, Needle):2	Touch(Right, Needle):1	 ->Grasp(Right, Needle)
512 Grasp(Right, Needle):0	Release(Right, Needle):2	Touch(Right, Needle):1	 ->Grasp(Right, Needle)
513 Grasp(Right, Needle):0	Release(Right, Needle):2	Touch(Right, Needle):1	 ->Grasp(Right, Needle)
514 Grasp(Right, Needle):0	Release(Right, Needle):2	Touch(Right, Needle):1	 ->Grasp(Right, Needle)
515 Grasp(Right, Needle):0	Release(Right, Needle):2	Touch(Right, Needle):1	 ->Grasp(Right, Needle)
516 Grasp(Right, Needle):0	Release(Right, Needle):2	Touch(Right, Needle):1	 ->Grasp(Right, Needle)
517 Grasp(Right, Needle):0	Release(Right, Needle):2	Touch(Right, Needle):1	 ->Grasp(Right, Needle)
518 Grasp(Right, Needle):0	Release(Right, Needle):2	Touch(Right, Needle):1	 ->Grasp(Right, Needle)
519 Grasp(Right, Needle):0	Release(Right, Needle):2	Touch(Right, Needle):1	 ->Grasp(Right, Needle)
520 Grasp(Right, Needle):0	Release(Right, Needle):2	Touch(Right, Needle):1	 ->Grasp(Right, Needle)
521 Grasp(Right, Needle):0	Release(Right, Needle):2	Touch(Right, Needle):1	 ->Grasp(Right, Needle)
522 Grasp(Right, Needle):0	Release(Right, Needle):2	Touch(Right, Needle):1	 ->Grasp(Right, Needle)
523 Grasp(Right, Needle):0	Release(Right, Needle):2	Touch(Right, Needle):1	 ->Grasp(Right, Needle)
524 Grasp(Right, Needle):0	Release(Right, Needle):2	Touch(Right, Needle):1	 ->Grasp(Right, Needle)
525 Grasp(Right, Needle):0	Release(Right, Needle):2	Touch(Right, Needle):1	 ->Grasp(Right, Needle)
526 Grasp(Right, Needle):0	Release(Right, Needle):2	Touch(Right, Needle):1	 ->Grasp(Right, Needle)
527 Grasp(Right, Needle):0	Release(Right, Needle):2	Touch(Right, Needle):1	 ->Grasp(Right, Needle)
528 Grasp(Right, Needle):0	Release(Right, Needle):2	Touch(Right, Needle):1	 ->Grasp(Right, Needle)
529 Grasp(Right, Needle):0	Release(Right, Needle):2	Touch(Right, Needle):1	 ->Grasp(Right, Needle)
530 Grasp(Right, Needle):0	Release(Right, Needle):2	Touch(Right, Needle):1	 ->Grasp(Right, Needle)
531 Grasp(Right, Needle):0	Release(Right, Needle):2	Touch(Right, Needle):1	 ->Grasp(Right, Needle)
532 Grasp(Right, Needle):0	Release(Right, Needle):2	Touch(Right, Needle):1	 ->Grasp(Right, Needle)
533 Grasp(Right, Needle):0	Release(Right, Needle):2	Grasp(Right, Needle):0	 ->Grasp(Right, Needle)
534 Grasp(Right, Needle):0	Release(Right, Needle):2	Grasp(Right, Needle):0	 ->Grasp(Right, Needle)
535 Grasp(Right, Needle):0	Release(Right, Needle):2	Grasp(Right, Needle):0	 ->Grasp(Right, Needle)
536 Grasp(Right, Needle):0	Release(Right, Needle):2	Grasp(Right, Needle):0	 ->Grasp(Right, Needle)
537 Grasp(Right, Needle):0	Grasp(Right, Needle):0	Grasp(Right, Needle):0	 ->Grasp(Right, Needle)
538 Grasp(Right, Needle):0	Grasp(Right, Needle):0	Grasp(Right, Needle):0	 ->Grasp(Right, Needle)
539 Grasp(Right, Needle):0	Grasp(Right, Needle):0	Grasp(Right, Needle):0	 ->Grasp(Right, Needle)
540 Grasp(Right, Needle):0	Grasp(Right, Needle):0	Grasp(Right, Needle):0	 ->Grasp(Right, Needle)
541 Grasp(Right, Needle):0	Grasp(Right, Needle):0	Grasp(Right, Needle):0	 ->Grasp(Right, Needle)
542 Grasp(Right, Needle):0	Grasp(Right, Needle):0	Grasp(Right, Needle):0	 ->Grasp(Right, Needle)
543 Grasp(Right, Needle):0	Grasp(Right, Needle):0	Grasp(Right, Needle):0	 ->Grasp(Right, Needle)
544 Grasp(Right, Needle):0	Grasp(Right, Needle):0	Grasp(Right, Needle):0	 ->Grasp(Right, Needle)
545 Grasp(Right, Needle):0	Grasp(Right, Needle):0	Grasp(Right, Needle):0	 ->Grasp(Right, Needle)
546 Grasp(Right, Needle):0	Grasp(Right, Needle):0	Release(Left, Needle):6	 ->Grasp(Right, Needle)
547 Grasp(Right, Needle):0	Grasp(Right, Needle):0	Release(Left, Needle):6	 ->Grasp(Right, Needle)
548 Grasp(Right, Needle):0	Grasp(Right, Needle):0	Release(Left, Needle):6	 ->Grasp(Right, Needle)
549 Grasp(Right, Needle):0	Grasp(Right, Needle):0	Release(Left, Needle):6	 ->Grasp(Right, Needle)
550 Grasp(Right, Needle):0	Grasp(Right, Needle):0	Release(Left, Needle):6	 ->Grasp(Right, Needle)
551 Grasp(Right, Needle):0	Grasp(Right, Needle):0	Release(Left, Needle):6	 ->Grasp(Right, Needle)
552 Push(Right, Needle):7	Grasp(Right, Needle):0	Release(Left, Needle):6	 ->Push(Right, Needle)
553 Push(Right, Needle):7	Grasp(Right, Needle):0	Release(Left, Needle):6	 ->Push(Right, Needle)
554 Push(Right, Needle):7	Grasp(Right, Needle):0	Release(Left, Needle):6	 ->Push(Right, Needle)
555 Push(Right, Needle):7	Grasp(Right, Needle):0	Release(Left, Needle):6	 ->Push(Right, Needle)
556 Push(Right, Needle):7	Grasp(Right, Needle):0	Release(Left, Needle):6	 ->Push(Right, Needle)
557 Push(Right, Needle):7	Grasp(Right, Needle):0	Release(Left, Needle):6	 ->Push(Right, Needle)
558 Push(Right, Needle):7	Grasp(Right, Needle):0	Release(Left, Needle):6	 ->Push(Right, Needle)
559 Push(Right, Needle):7	Grasp(Right, Needle):0	Release(Left, Needle):6	 ->Push(Right, Needle)
560 Push(Right, Needle):7	Grasp(Right, Needle):0	Release(Left, Needle):6	 ->Push(Right, Needle)
561 Push(Right, Needle):7	Grasp(Right, Needle):0	Release(Left, Needle):6	 ->Push(Right, Needle)
562 Push(Right, Needle):7	Grasp(Right, Needle):0	Release(Left, Needle):6	 ->Push(Right, Needle)
563 Push(Right, Needle):7	Grasp(Right, Needle):0	Untouch(Left, Needle):8	 ->Push(Right, Needle)
564 Push(Right, Needle):7	Release(Left, Needle):6	Untouch(Left, Needle):8	 ->Push(Right, Needle)
565 Push(Right, Needle):7	Release(Left, Needle):6	Untouch(Left, Needle):8	 ->Push(Right, Needle)
566 Push(Right, Needle):7	Release(Left, Needle):6	Untouch(Left, Needle):8	 ->Push(Right, Needle)
567 Push(Right, Needle):7	Release(Left, Needle):6	Untouch(Left, Needle):8	 ->Push(Right, Needle)
568 Push(Right, Needle):7	Release(Left, Needle):6	Push(Right, Needle):7	 ->Push(Right, Needle)
569 Push(Right, Needle):7	Release(Left, Needle):6	Push(Right, Needle):7	 ->Push(Right, Needle)
570 Push(Right, Needle):7	Release(Left, Needle):6	Push(Right, Needle):7	 ->Push(Right, Needle)
571 Push(Right, Needle):7	Release(Left, Needle):6	Push(Right, Needle):7	 ->Push(Right, Needle)
572 Push(Right, Needle):7	Release(Left, Needle):6	Push(Right, Needle):7	 ->Push(Right, Needle)
573 Push(Right, Needle):7	Release(Left, Needle):6	Push(Right, Needle):7	 ->Push(Right, Needle)
574 Push(Right, Needle):7	Release(Left, Needle):6	Push(Right, Needle):7	 ->Push(Right, Needle)
575 Push(Right, Needle):7	Release(Left, Needle):6	Push(Right, Needle):7	 ->Push(Right, Needle)
576 Push(Right, Needle):7	Release(Left, Needle):6	Push(Right, Needle):7	 ->Push(Right, Needle)
577 Push(Right, Needle):7	Release(Left, Needle):6	Push(Right, Needle):7	 ->Push(Right, Needle)
578 Push(Right, Needle):7	Release(Left, Needle):6	Push(Right, Needle):7	 ->Push(Right, Needle)
579 Push(Right, Needle):7	Release(Left, Needle):6	Push(Right, Needle):7	 ->Push(Right, Needle)
580 Push(Right, Needle):7	Release(Left, Needle):6	Push(Right, Needle):7	 ->Push(Right, Needle)
581 Push(Right, Needle):7	Release(Left, Needle):6	Push(Right, Needle):7	 ->Push(Right, Needle)
582 Push(Right, Needle):7	Release(Left, Needle):6	Push(Right, Needle):7	 ->Push(Right, Needle)
583 Push(Right, Needle):7	Release(Left, Needle):6	Push(Right, Needle):7	 ->Push(Right, Needle)
584 Push(Right, Needle):7	Release(Left, Needle):6	Push(Right, Needle):7	 ->Push(Right, Needle)
585 Push(Right, Needle):7	Release(Left, Needle):6	Push(Right, Needle):7	 ->Push(Right, Needle)
586 Push(Right, Needle):7	Release(Left, Needle):6	Push(Right, Needle):7	 ->Push(Right, Needle)
587 Push(Right, Needle):7	Release(Left, Needle):6	Push(Right, Needle):7	 ->Push(Right, Needle)
588 Push(Right, Needle):7	Release(Left, Needle):6	Push(Right, Needle):7	 ->Push(Right, Needle)
589 Push(Right, Needle):7	Release(Left, Needle):6	Push(Right, Needle):7	 ->Push(Right, Needle)
590 Push(Right, Needle):7	Release(Left, Needle):6	Push(Right, Needle):7	 ->Push(Right, Needle)
591 Push(Right, Needle):7	Release(Left, Needle):6	Push(Right, Needle):7	 ->Push(Right, Needle)
592 Push(Right, Needle):7	Release(Left, Needle):6	Push(Right, Needle):7	 ->Push(Right, Needle)
593 Push(Right, Needle):7	Release(Left, Needle):6	Push(Right, Needle):7	 ->Push(Right, Needle)
594 Push(Right, Needle):7	Release(Left, Needle):6	Push(Right, Needle):7	 ->Push(Right, Needle)
595 Push(Right, Needle):7	Release(Left, Needle):6	Push(Right, Needle):7	 ->Push(Right, Needle)
596 Push(Right, Needle):7	Release(Left, Needle):6	Push(Right, Needle):7	 ->Push(Right, Needle)
597 Push(Right, Needle):7	Release(Left, Needle):6	Push(Right, Needle):7	 ->Push(Right, Needle)
598 Push(Right, Needle):7	Release(Left, Needle):6	Push(Right, Needle):7	 ->Push(Right, Needle)
599 Push(Right, Needle):7	Release(Left, Needle):6	Push(Right, Needle):7	 ->Push(Right, Needle)
600 Push(Right, Needle):7	Release(Left, Needle):6	Push(Right, Needle):7	 ->Push(Right, Needle)
601 Push(Right, Needle):7	Release(Left, Needle):6	Push(Right, Needle):7	 ->Push(Right, Needle)
602 Push(Right, Needle):7	Release(Left, Needle):6	Push(Right, Needle):7	 ->Push(Right, Needle)
603 Push(Right, Needle):7	Release(Left, Needle):6	Push(Right, Needle):7	 ->Push(Right, Needle)
604 Push(Right, Needle):7	Release(Left, Needle):6	Push(Right, Needle):7	 ->Push(Right, Needle)
605 Push(Right, Needle):7	Release(Left, Needle):6	Push(Right, Needle):7	 ->Push(Right, Needle)
606 Push(Right, Needle):7	Release(Left, Needle):6	Push(Right, Needle):7	 ->Push(Right, Needle)
607 Push(Right, Needle):7	Release(Left, Needle):6	Push(Right, Needle):7	 ->Push(Right, Needle)
608 Push(Right, Needle):7	Release(Left, Needle):6	Push(Right, Needle):7	 ->Push(Right, Needle)
609 Push(Right, Needle):7	Release(Left, Needle):6	Push(Right, Needle):7	 ->Push(Right, Needle)
610 Push(Right, Needle):7	Release(Left, Needle):6	Push(Right, Needle):7	 ->Push(Right, Needle)
611 Push(Right, Needle):7	Release(Left, Needle):6	Push(Right, Needle):7	 ->Push(Right, Needle)
612 Push(Right, Needle):7	Release(Left, Needle):6	Push(Right, Needle):7	 ->Push(Right, Needle)
613 Push(Right, Needle):7	Release(Left, Needle):6	Push(Right, Needle):7	 ->Push(Right, Needle)
614 Push(Right, Needle):7	Release(Left, Needle):6	Push(Right, Needle):7	 ->Push(Right, Needle)
615 Push(Right, Needle):7	Release(Left, Needle):6	Push(Right, Needle):7	 ->Push(Right, Needle)
616 Push(Right, Needle):7	Release(Left, Needle):6	Push(Right, Needle):7	 ->Push(Right, Needle)
617 Push(Right, Needle):7	Release(Left, Needle):6	Push(Right, Needle):7	 ->Push(Right, Needle)
618 Push(Right, Needle):7	Release(Left, Needle):6	Push(Right, Needle):7	 ->Push(Right, Needle)
619 Push(Right, Needle):7	Release(Left, Needle):6	Push(Right, Needle):7	 ->Push(Right, Needle)
620 Push(Right, Needle):7	Release(Left, Needle):6	Push(Right, Needle):7	 ->Push(Right, Needle)
621 Push(Right, Needle):7	Release(Left, Needle):6	Push(Right, Needle):7	 ->Push(Right, Needle)
622 Push(Right, Needle):7	Release(Left, Needle):6	Push(Right, Needle):7	 ->Push(Right, Needle)
623 Push(Right, Needle):7	Release(Left, Needle):6	Push(Right, Needle):7	 ->Push(Right, Needle)
624 Push(Right, Needle):7	Release(Left, Needle):6	Push(Right, Needle):7	 ->Push(Right, Needle)
625 Push(Right, Needle):7	Release(Left, Needle):6	Push(Right, Needle):7	 ->Push(Right, Needle)
626 Push(Right, Needle):7	Release(Left, Needle):6	Push(Right, Needle):7	 ->Push(Right, Needle)
627 Push(Right, Needle):7	Release(Left, Needle):6	Push(Right, Needle):7	 ->Push(Right, Needle)
628 Push(Right, Needle):7	Release(Left, Needle):6	Push(Right, Needle):7	 ->Push(Right, Needle)
629 Push(Right, Needle):7	Release(Left, Needle):6	Push(Right, Needle):7	 ->Push(Right, Needle)
630 Push(Right, Needle):7	Release(Left, Needle):6	Push(Right, Needle):7	 ->Push(Right, Needle)
631 Push(Right, Needle):7	Release(Left, Needle):6	Push(Right, Needle):7	 ->Push(Right, Needle)
632 Push(Right, Needle):7	Release(Left, Needle):6	Push(Right, Needle):7	 ->Push(Right, Needle)
633 Push(Right, Needle):7	Release(Left, Needle):6	Push(Right, Needle):7	 ->Push(Right, Needle)
634 Push(Right, Needle):7	Release(Left, Needle):6	Push(Right, Needle):7	 ->Push(Right, Needle)
635 Push(Right, Needle):7	Release(Left, Needle):6	Push(Right, Needle):7	 ->Push(Right, Needle)
636 Push(Right, Needle):7	Release(Left, Needle):6	Push(Right, Needle):7	 ->Push(Right, Needle)
637 Push(Right, Needle):7	Release(Left, Needle):6	Push(Right, Needle):7	 ->Push(Right, Needle)
638 Push(Right, Needle):7	Release(Left, Needle):6	Push(Right, Needle):7	 ->Push(Right, Needle)
639 Push(Right, Needle):7	Push(Right, Needle):7	Push(Right, Needle):7	 ->Push(Right, Needle)
640 Push(Right, Needle):7	Push(Right, Needle):7	Push(Right, Needle):7	 ->Push(Right, Needle)
641 Push(Right, Needle):7	Push(Right, Needle):7	Push(Right, Needle):7	 ->Push(Right, Needle)
642 Push(Right, Needle):7	Push(Right, Needle):7	Push(Right, Needle):7	 ->Push(Right, Needle)
643 Push(Right, Needle):7	Push(Right, Needle):7	Push(Right, Needle):7	 ->Push(Right, Needle)
644 Push(Right, Needle):7	Push(Right, Needle):7	Push(Right, Needle):7	 ->Push(Right, Needle)
645 Push(Right, Needle):7	Push(Right, Needle):7	Push(Right, Needle):7	 ->Push(Right, Needle)
646 Push(Right, Needle):7	Push(Right, Needle):7	Push(Right, Needle):7	 ->Push(Right, Needle)
647 Push(Right, Needle):7	Push(Right, Needle):7	Push(Right, Needle):7	 ->Push(Right, Needle)
648 Push(Right, Needle):7	Push(Right, Needle):7	Push(Right, Needle):7	 ->Push(Right, Needle)
649 Push(Right, Needle):7	Push(Right, Needle):7	Push(Right, Needle):7	 ->Push(Right, Needle)
650 Push(Right, Needle):7	Push(Right, Needle):7	Push(Right, Needle):7	 ->Push(Right, Needle)
651 Push(Right, Needle):7	Push(Right, Needle):7	Push(Right, Needle):7	 ->Push(Right, Needle)
652 Push(Right, Needle):7	Push(Right, Needle):7	Push(Right, Needle):7	 ->Push(Right, Needle)
653 Push(Right, Needle):7	Push(Right, Needle):7	Push(Right, Needle):7	 ->Push(Right, Needle)
654 Push(Right, Needle):7	Push(Right, Needle):7	Push(Right, Needle):7	 ->Push(Right, Needle)
655 Push(Right, Needle):7	Push(Right, Needle):7	Push(Right, Needle):7	 ->Push(Right, Needle)
656 Push(Right, Needle):7	Push(Right, Needle):7	Push(Right, Needle):7	 ->Push(Right, Needle)
657 Push(Right, Needle):7	Push(Right, Needle):7	Push(Right, Needle):7	 ->Push(Right, Needle)
658 Push(Right, Needle):7	Push(Right, Needle):7	Push(Right, Needle):7	 ->Push(Right, Needle)
659 Push(Right, Needle):7	Push(Right, Needle):7	Push(Right, Needle):7	 ->Push(Right, Needle)
660 Push(Right, Needle):7	Push(Right, Needle):7	Push(Right, Needle):7	 ->Push(Right, Needle)
661 Push(Right, Needle):7	Push(Right, Needle):7	Push(Right, Needle):7	 ->Push(Right, Needle)
662 Push(Right, Needle):7	Push(Right, Needle):7	Push(Right, Needle):7	 ->Push(Right, Needle)
663 Push(Right, Needle):7	Push(Right, Needle):7	Push(Right, Needle):7	 ->Push(Right, Needle)
664 Push(Right, Needle):7	Push(Right, Needle):7	Push(Right, Needle):7	 ->Push(Right, Needle)
665 Push(Right, Needle):7	Push(Right, Needle):7	Push(Right, Needle):7	 ->Push(Right, Needle)
666 Push(Right, Needle):7	Push(Right, Needle):7	Touch(Left, Needle):4	 ->Push(Right, Needle)
667 Push(Right, Needle):7	Push(Right, Needle):7	Touch(Left, Needle):4	 ->Push(Right, Needle)
668 Push(Right, Needle):7	Push(Right, Needle):7	Touch(Left, Needle):4	 ->Push(Right, Needle)
669 Push(Right, Needle):7	Push(Right, Needle):7	Touch(Left, Needle):4	 ->Push(Right, Needle)
670 Push(Right, Needle):7	Push(Right, Needle):7	Touch(Left, Needle):4	 ->Push(Right, Needle)
671 Push(Right, Needle):7	Push(Right, Needle):7	Touch(Left, Needle):4	 ->Push(Right, Needle)
672 Push(Right, Needle):7	Push(Right, Needle):7	Touch(Left, Needle):4	 ->Push(Right, Needle)
673 Push(Right, Needle):7	Push(Right, Needle):7	Touch(Left, Needle):4	 ->Push(Right, Needle)
674 Push(Right, Needle):7	Push(Right, Needle):7	Touch(Left, Needle):4	 ->Push(Right, Needle)
675 Push(Right, Needle):7	Push(Right, Needle):7	Touch(Left, Needle):4	 ->Push(Right, Needle)
676 Grasp(Left, Needle):5	Push(Right, Needle):7	Touch(Left, Needle):4	 ->Grasp(Left, Needle)
677 Grasp(Left, Needle):5	Push(Right, Needle):7	Touch(Left, Needle):4	 ->Grasp(Left, Needle)
678 Grasp(Left, Needle):5	Push(Right, Needle):7	Touch(Left, Needle):4	 ->Grasp(Left, Needle)
679 Grasp(Left, Needle):5	Push(Right, Needle):7	Touch(Left, Needle):4	 ->Grasp(Left, Needle)
680 Grasp(Left, Needle):5	Push(Right, Needle):7	Touch(Left, Needle):4	 ->Grasp(Left, Needle)
681 Grasp(Left, Needle):5	Push(Right, Needle):7	Touch(Left, Needle):4	 ->Grasp(Left, Needle)
682 Grasp(Left, Needle):5	Push(Right, Needle):7	Touch(Left, Needle):4	 ->Grasp(Left, Needle)
683 Grasp(Left, Needle):5	Push(Right, Needle):7	Touch(Left, Needle):4	 ->Grasp(Left, Needle)
684 Grasp(Left, Needle):5	Push(Right, Needle):7	Touch(Left, Needle):4	 ->Grasp(Left, Needle)
685 Grasp(Left, Needle):5	Push(Right, Needle):7	Touch(Left, Needle):4	 ->Grasp(Left, Needle)
686 Grasp(Left, Needle):5	Push(Right, Needle):7	Touch(Left, Needle):4	 ->Grasp(Left, Needle)
687 Grasp(Left, Needle):5	Push(Right, Needle):7	Touch(Left, Needle):4	 ->Grasp(Left, Needle)
688 Grasp(Left, Needle):5	Push(Right, Needle):7	Touch(Left, Needle):4	 ->Grasp(Left, Needle)
689 Grasp(Left, Needle):5	Push(Right, Needle):7	Touch(Left, Needle):4	 ->Grasp(Left, Needle)
690 Grasp(Left, Needle):5	Push(Right, Needle):7	Touch(Left, Needle):4	 ->Grasp(Left, Needle)
691 Grasp(Left, Needle):5	Push(Right, Needle):7	Touch(Left, Needle):4	 ->Grasp(Left, Needle)
692 Grasp(Left, Needle):5	Push(Right, Needle):7	Touch(Left, Needle):4	 ->Grasp(Left, Needle)
693 Grasp(Left, Needle):5	Push(Right, Needle):7	Touch(Left, Needle):4	 ->Grasp(Left, Needle)
694 Grasp(Left, Needle):5	Push(Right, Needle):7	Touch(Left, Needle):4	 ->Grasp(Left, Needle)
695 Grasp(Left, Needle):5	Push(Right, Needle):7	Touch(Left, Needle):4	 ->Grasp(Left, Needle)
696 Grasp(Left, Needle):5	Push(Right, Needle):7	Touch(Left, Needle):4	 ->Grasp(Left, Needle)
697 Grasp(Left, Needle):5	Push(Right, Needle):7	Touch(Left, Needle):4	 ->Grasp(Left, Needle)
698 Grasp(Left, Needle):5	Push(Right, Needle):7	Touch(Left, Needle):4	 ->Grasp(Left, Needle)
699 Grasp(Left, Needle):5	Push(Right, Needle):7	Touch(Left, Needle):4	 ->Grasp(Left, Needle)
700 Grasp(Left, Needle):5	Push(Right, Needle):7	Touch(Left, Needle):4	 ->Grasp(Left, Needle)
701 Grasp(Left, Needle):5	Push(Right, Needle):7	Touch(Left, Needle):4	 ->Grasp(Left, Needle)
702 Grasp(Left, Needle):5	Push(Right, Needle):7	Touch(Left, Needle):4	 ->Grasp(Left, Needle)
703 Grasp(Left, Needle):5	Push(Right, Needle):7	Touch(Left, Needle):4	 ->Grasp(Left, Needle)
704 Grasp(Left, Needle):5	Push(Right, Needle):7	Touch(Left, Needle):4	 ->Grasp(Left, Needle)
705 Grasp(Left, Needle):5	Push(Right, Needle):7	Touch(Left, Needle):4	 ->Grasp(Left, Needle)
706 Grasp(Left, Needle):5	Push(Right, Needle):7	Touch(Left, Needle):4	 ->Grasp(Left, Needle)
707 Grasp(Left, Needle):5	Push(Right, Needle):7	Touch(Left, Needle):4	 ->Grasp(Left, Needle)
708 Grasp(Left, Needle):5	Push(Right, Needle):7	Touch(Left, Needle):4	 ->Grasp(Left, Needle)
709 Grasp(Left, Needle):5	Push(Right, Needle):7	Touch(Left, Needle):4	 ->Grasp(Left, Needle)
710 Grasp(Left, Needle):5	Push(Right, Needle):7	Touch(Left, Needle):4	 ->Grasp(Left, Needle)
711 Grasp(Left, Needle):5	Push(Right, Needle):7	Grasp(Left, Needle):5	 ->Grasp(Left, Needle)
712 Grasp(Left, Needle):5	Push(Right, Needle):7	Grasp(Left, Needle):5	 ->Grasp(Left, Needle)
713 Grasp(Left, Needle):5	Push(Right, Needle):7	Grasp(Left, Needle):5	 ->Grasp(Left, Needle)
714 Grasp(Left, Needle):5	Push(Right, Needle):7	Grasp(Left, Needle):5	 ->Grasp(Left, Needle)
715 Grasp(Left, Needle):5	Push(Right, Needle):7	Grasp(Left, Needle):5	 ->Grasp(Left, Needle)
716 Grasp(Left, Needle):5	Push(Right, Needle):7	Grasp(Left, Needle):5	 ->Grasp(Left, Needle)
717 Grasp(Left, Needle):5	Grasp(Left, Needle):5	Grasp(Left, Needle):5	 ->Grasp(Left, Needle)
718 Grasp(Left, Needle):5	Grasp(Left, Needle):5	Grasp(Left, Needle):5	 ->Grasp(Left, Needle)
719 Grasp(Left, Needle):5	Grasp(Left, Needle):5	Grasp(Left, Needle):5	 ->Grasp(Left, Needle)
720 Grasp(Left, Needle):5	Grasp(Left, Needle):5	Grasp(Left, Needle):5	 ->Grasp(Left, Needle)
721 Grasp(Left, Needle):5	Grasp(Left, Needle):5	Release(Right, Needle):2	 ->Grasp(Left, Needle)
722 Grasp(Left, Needle):5	Grasp(Left, Needle):5	Release(Right, Needle):2	 ->Grasp(Left, Needle)
723 Grasp(Left, Needle):5	Grasp(Left, Needle):5	Release(Right, Needle):2	 ->Grasp(Left, Needle)
724 Grasp(Left, Needle):5	Grasp(Left, Needle):5	Release(Right, Needle):2	 ->Grasp(Left, Needle)
725 Grasp(Left, Needle):5	Grasp(Left, Needle):5	Release(Right, Needle):2	 ->Grasp(Left, Needle)
726 Grasp(Left, Needle):5	Grasp(Left, Needle):5	Release(Right, Needle):2	 ->Grasp(Left, Needle)
727 Grasp(Left, Needle):5	Grasp(Left, Needle):5	Release(Right, Needle):2	 ->Grasp(Left, Needle)
728 Grasp(Left, Needle):5	Grasp(Left, Needle):5	Release(Right, Needle):2	 ->Grasp(Left, Needle)
729 Grasp(Left, Needle):5	Grasp(Left, Needle):5	Pull(Left, Needle):9	 ->Grasp(Left, Needle)
730 Grasp(Left, Needle):5	Grasp(Left, Needle):5	Pull(Left, Needle):9	 ->Grasp(Left, Needle)
731 Grasp(Left, Needle):5	Grasp(Left, Needle):5	Pull(Left, Needle):9	 ->Grasp(Left, Needle)
732 Grasp(Left, Needle):5	Release(Right, Needle):2	Pull(Left, Needle):9	 ->Grasp(Left, Needle)
733 Grasp(Left, Needle):5	Release(Right, Needle):2	Pull(Left, Needle):9	 ->Grasp(Left, Needle)
734 Grasp(Left, Needle):5	Release(Right, Needle):2	Pull(Left, Needle):9	 ->Grasp(Left, Needle)
735 Grasp(Left, Needle):5	Release(Right, Needle):2	Pull(Left, Needle):9	 ->Grasp(Left, Needle)
736 Grasp(Left, Needle):5	Release(Right, Needle):2	Pull(Left, Needle):9	 ->Grasp(Left, Needle)
737 Grasp(Left, Needle):5	Release(Right, Needle):2	Pull(Left, Needle):9	 ->Grasp(Left, Needle)
738 Grasp(Left, Needle):5	Release(Right, Needle):2	Pull(Left, Needle):9	 ->Grasp(Left, Needle)
739 Grasp(Left, Needle):5	Release(Right, Needle):2	Pull(Left, Needle):9	 ->Grasp(Left, Needle)
740 Grasp(Left, Needle):5	Release(Right, Needle):2	Pull(Left, Needle):9	 ->Grasp(Left, Needle)
741 Grasp(Left, Needle):5	Release(Right, Needle):2	Pull(Left, Needle):9	 ->Grasp(Left, Needle)
742 Grasp(Left, Needle):5	Release(Right, Needle):2	Pull(Left, Needle):9	 ->Grasp(Left, Needle)
743 Grasp(Left, Needle):5	Release(Right, Needle):2	Pull(Left, Needle):9	 ->Grasp(Left, Needle)
744 Grasp(Left, Needle):5	Release(Right, Needle):2	Pull(Left, Needle):9	 ->Grasp(Left, Needle)
745 Grasp(Left, Needle):5	Release(Right, Needle):2	Pull(Left, Needle):9	 ->Grasp(Left, Needle)
746 Grasp(Left, Needle):5	Release(Right, Needle):2	Pull(Left, Needle):9	 ->Grasp(Left, Needle)
747 Grasp(Left, Needle):5	Release(Right, Needle):2	Pull(Left, Needle):9	 ->Grasp(Left, Needle)
748 Grasp(Left, Needle):5	Release(Right, Needle):2	Pull(Left, Needle):9	 ->Grasp(Left, Needle)
749 Grasp(Left, Needle):5	Release(Right, Needle):2	Pull(Left, Needle):9	 ->Grasp(Left, Needle)
750 Grasp(Left, Needle):5	Release(Right, Needle):2	Pull(Left, Needle):9	 ->Grasp(Left, Needle)
751 Grasp(Left, Needle):5	Release(Right, Needle):2	Pull(Left, Needle):9	 ->Grasp(Left, Needle)
752 Grasp(Left, Needle):5	Release(Right, Needle):2	Pull(Left, Needle):9	 ->Grasp(Left, Needle)
753 Grasp(Left, Needle):5	Release(Right, Needle):2	Pull(Left, Needle):9	 ->Grasp(Left, Needle)
754 Grasp(Left, Needle):5	Release(Right, Needle):2	Pull(Left, Needle):9	 ->Grasp(Left, Needle)
755 Grasp(Left, Needle):5	Release(Right, Needle):2	Pull(Left, Needle):9	 ->Grasp(Left, Needle)
756 Grasp(Left, Needle):5	Release(Right, Needle):2	Pull(Left, Needle):9	 ->Grasp(Left, Needle)
757 Grasp(Left, Needle):5	Release(Right, Needle):2	Pull(Left, Needle):9	 ->Grasp(Left, Needle)
758 Grasp(Left, Needle):5	Release(Right, Needle):2	Pull(Left, Needle):9	 ->Grasp(Left, Needle)
759 Grasp(Right, Needle):0	Release(Right, Needle):2	Pull(Left, Needle):9	 ->Grasp(Right, Needle)
760 Grasp(Right, Needle):0	Release(Right, Needle):2	Pull(Left, Needle):9	 ->Grasp(Right, Needle)
761 Grasp(Right, Needle):0	Release(Right, Needle):2	Pull(Left, Needle):9	 ->Grasp(Right, Needle)
762 Grasp(Right, Needle):0	Release(Right, Needle):2	Pull(Left, Needle):9	 ->Grasp(Right, Needle)
763 Grasp(Right, Needle):0	Release(Right, Needle):2	Pull(Left, Needle):9	 ->Grasp(Right, Needle)
764 Grasp(Right, Needle):0	Release(Right, Needle):2	Pull(Left, Needle):9	 ->Grasp(Right, Needle)
765 Grasp(Right, Needle):0	Release(Right, Needle):2	Pull(Left, Needle):9	 ->Grasp(Right, Needle)
766 Grasp(Right, Needle):0	Release(Right, Needle):2	Pull(Left, Needle):9	 ->Grasp(Right, Needle)
767 Grasp(Right, Needle):0	Release(Right, Needle):2	Pull(Left, Needle):9	 ->Grasp(Right, Needle)
768 Grasp(Right, Needle):0	Release(Right, Needle):2	Pull(Left, Needle):9	 ->Grasp(Right, Needle)
769 Grasp(Right, Needle):0	Release(Right, Needle):2	Pull(Left, Needle):9	 ->Grasp(Right, Needle)
770 Grasp(Right, Needle):0	Pull(Left, Needle):9	Pull(Left, Needle):9	 ->Pull(Left, Needle)
771 Grasp(Right, Needle):0	Pull(Left, Needle):9	Pull(Left, Needle):9	 ->Pull(Left, Needle)
772 Grasp(Right, Needle):0	Pull(Left, Needle):9	Pull(Left, Needle):9	 ->Pull(Left, Needle)
773 Grasp(Right, Needle):0	Pull(Left, Needle):9	Pull(Left, Needle):9	 ->Pull(Left, Needle)
774 Grasp(Right, Needle):0	Pull(Left, Needle):9	Pull(Left, Needle):9	 ->Pull(Left, Needle)
775 Grasp(Right, Needle):0	Pull(Left, Needle):9	Pull(Left, Needle):9	 ->Pull(Left, Needle)
776 Grasp(Right, Needle):0	Pull(Left, Needle):9	Pull(Left, Needle):9	 ->Pull(Left, Needle)
777 Grasp(Right, Needle):0	Pull(Left, Needle):9	Pull(Left, Needle):9	 ->Pull(Left, Needle)
778 Grasp(Right, Needle):0	Pull(Left, Needle):9	Pull(Left, Needle):9	 ->Pull(Left, Needle)
779 Grasp(Right, Needle):0	Pull(Left, Needle):9	Pull(Left, Needle):9	 ->Pull(Left, Needle)
780 Grasp(Right, Needle):0	Pull(Left, Needle):9	Pull(Left, Needle):9	 ->Pull(Left, Needle)
781 Grasp(Right, Needle):0	Pull(Left, Needle):9	Pull(Left, Needle):9	 ->Pull(Left, Needle)
782 Grasp(Right, Needle):0	Pull(Left, Needle):9	Pull(Left, Needle):9	 ->Pull(Left, Needle)
783 Grasp(Right, Needle):0	Pull(Left, Needle):9	Pull(Left, Needle):9	 ->Pull(Left, Needle)
784 Grasp(Right, Needle):0	Pull(Left, Needle):9	Pull(Left, Needle):9	 ->Pull(Left, Needle)
785 Grasp(Right, Needle):0	Pull(Left, Needle):9	Pull(Left, Needle):9	 ->Pull(Left, Needle)
786 Grasp(Right, Needle):0	Pull(Left, Needle):9	Pull(Left, Needle):9	 ->Pull(Left, Needle)
787 Grasp(Right, Needle):0	Pull(Left, Needle):9	Pull(Left, Needle):9	 ->Pull(Left, Needle)
788 Grasp(Right, Needle):0	Pull(Left, Needle):9	Touch(Right, Needle):1	 ->Grasp(Right, Needle)
789 Grasp(Right, Needle):0	Pull(Left, Needle):9	Touch(Right, Needle):1	 ->Grasp(Right, Needle)
790 Grasp(Right, Needle):0	Pull(Left, Needle):9	Touch(Right, Needle):1	 ->Grasp(Right, Needle)
791 Grasp(Right, Needle):0	Pull(Left, Needle):9	Touch(Right, Needle):1	 ->Grasp(Right, Needle)
792 Grasp(Right, Needle):0	Pull(Left, Needle):9	Touch(Right, Needle):1	 ->Grasp(Right, Needle)
793 Grasp(Right, Needle):0	Pull(Left, Needle):9	Touch(Right, Needle):1	 ->Grasp(Right, Needle)
794 Grasp(Right, Needle):0	Pull(Left, Needle):9	Touch(Right, Needle):1	 ->Grasp(Right, Needle)
795 Grasp(Right, Needle):0	Pull(Left, Needle):9	Touch(Right, Needle):1	 ->Grasp(Right, Needle)
796 Grasp(Right, Needle):0	Pull(Left, Needle):9	Touch(Right, Needle):1	 ->Grasp(Right, Needle)
797 Grasp(Right, Needle):0	Pull(Left, Needle):9	Touch(Right, Needle):1	 ->Grasp(Right, Needle)
798 Grasp(Right, Needle):0	Pull(Left, Needle):9	Touch(Right, Needle):1	 ->Grasp(Right, Needle)
799 Grasp(Right, Needle):0	Pull(Left, Needle):9	Touch(Right, Needle):1	 ->Grasp(Right, Needle)
800 Grasp(Right, Needle):0	Pull(Left, Needle):9	Touch(Right, Needle):1	 ->Grasp(Right, Needle)
801 Grasp(Right, Needle):0	Pull(Left, Needle):9	Touch(Right, Needle):1	 ->Grasp(Right, Needle)
802 Grasp(Right, Needle):0	Pull(Left, Needle):9	Touch(Right, Needle):1	 ->Grasp(Right, Needle)
803 Grasp(Right, Needle):0	Pull(Left, Needle):9	Touch(Right, Needle):1	 ->Grasp(Right, Needle)
804 Grasp(Right, Needle):0	Pull(Left, Needle):9	Touch(Right, Needle):1	 ->Grasp(Right, Needle)
805 Grasp(Right, Needle):0	Pull(Left, Needle):9	Touch(Right, Needle):1	 ->Grasp(Right, Needle)
806 Grasp(Right, Needle):0	Pull(Left, Needle):9	Touch(Right, Needle):1	 ->Grasp(Right, Needle)
807 Grasp(Right, Needle):0	Pull(Left, Needle):9	Touch(Right, Needle):1	 ->Grasp(Right, Needle)
808 Grasp(Right, Needle):0	Pull(Left, Needle):9	Touch(Right, Needle):1	 ->Grasp(Right, Needle)
809 Grasp(Right, Needle):0	Pull(Left, Needle):9	Touch(Right, Needle):1	 ->Grasp(Right, Needle)
810 Grasp(Right, Needle):0	Pull(Left, Needle):9	Touch(Right, Needle):1	 ->Grasp(Right, Needle)
811 Grasp(Right, Needle):0	Pull(Left, Needle):9	Touch(Right, Needle):1	 ->Grasp(Right, Needle)
812 Grasp(Right, Needle):0	Pull(Left, Needle):9	Touch(Right, Needle):1	 ->Grasp(Right, Needle)
813 Grasp(Right, Needle):0	Pull(Left, Needle):9	Touch(Right, Needle):1	 ->Grasp(Right, Needle)
814 Grasp(Right, Needle):0	Pull(Left, Needle):9	Touch(Right, Needle):1	 ->Grasp(Right, Needle)
815 Grasp(Right, Needle):0	Pull(Left, Needle):9	Touch(Right, Needle):1	 ->Grasp(Right, Needle)
816 Grasp(Right, Needle):0	Pull(Left, Needle):9	Touch(Right, Needle):1	 ->Grasp(Right, Needle)
817 Grasp(Right, Needle):0	Pull(Left, Needle):9	Touch(Right, Needle):1	 ->Grasp(Right, Needle)
818 Grasp(Right, Needle):0	Pull(Left, Needle):9	Touch(Right, Needle):1	 ->Grasp(Right, Needle)
819 Grasp(Right, Needle):0	Pull(Left, Needle):9	Touch(Right, Needle):1	 ->Grasp(Right, Needle)
820 Grasp(Right, Needle):0	Pull(Left, Needle):9	Touch(Right, Needle):1	 ->Grasp(Right, Needle)
821 Grasp(Right, Needle):0	Pull(Left, Needle):9	Touch(Right, Needle):1	 ->Grasp(Right, Needle)
822 Grasp(Right, Needle):0	Pull(Left, Needle):9	Touch(Right, Needle):1	 ->Grasp(Right, Needle)
823 Grasp(Right, Needle):0	Pull(Left, Needle):9	Touch(Right, Needle):1	 ->Grasp(Right, Needle)
824 Grasp(Right, Needle):0	Pull(Left, Needle):9	Touch(Right, Needle):1	 ->Grasp(Right, Needle)
825 Grasp(Right, Needle):0	Pull(Left, Needle):9	Touch(Right, Needle):1	 ->Grasp(Right, Needle)
826 Grasp(Right, Needle):0	Pull(Left, Needle):9	Touch(Right, Needle):1	 ->Grasp(Right, Needle)
827 Grasp(Right, Needle):0	Pull(Left, Needle):9	Touch(Right, Needle):1	 ->Grasp(Right, Needle)
828 Grasp(Right, Needle):0	Pull(Left, Needle):9	Touch(Right, Needle):1	 ->Grasp(Right, Needle)
829 Grasp(Right, Needle):0	Pull(Left, Needle):9	Touch(Right, Needle):1	 ->Grasp(Right, Needle)
830 Grasp(Right, Needle):0	Pull(Left, Needle):9	Touch(Right, Needle):1	 ->Grasp(Right, Needle)
831 Grasp(Right, Needle):0	Pull(Left, Needle):9	Touch(Right, Needle):1	 ->Grasp(Right, Needle)
832 Grasp(Right, Needle):0	Pull(Left, Needle):9	Touch(Right, Needle):1	 ->Grasp(Right, Needle)
833 Grasp(Right, Needle):0	Pull(Left, Needle):9	Touch(Right, Needle):1	 ->Grasp(Right, Needle)
834 Grasp(Right, Needle):0	Pull(Left, Needle):9	Touch(Right, Needle):1	 ->Grasp(Right, Needle)
835 Grasp(Right, Needle):0	Pull(Left, Needle):9	Touch(Right, Needle):1	 ->Grasp(Right, Needle)
836 Grasp(Right, Needle):0	Pull(Left, Needle):9	Touch(Right, Needle):1	 ->Grasp(Right, Needle)
837 Grasp(Right, Needle):0	Pull(Left, Needle):9	Touch(Right, Needle):1	 ->Grasp(Right, Needle)
838 Grasp(Right, Needle):0	Pull(Left, Needle):9	Touch(Right, Needle):1	 ->Grasp(Right, Needle)
839 Grasp(Right, Needle):0	Pull(Left, Needle):9	Touch(Right, Needle):1	 ->Grasp(Right, Needle)
840 Grasp(Right, Needle):0	Pull(Left, Needle):9	Touch(Right, Needle):1	 ->Grasp(Right, Needle)
841 Grasp(Right, Needle):0	Pull(Left, Needle):9	Touch(Right, Needle):1	 ->Grasp(Right, Needle)
842 Grasp(Right, Needle):0	Pull(Left, Needle):9	Touch(Right, Needle):1	 ->Grasp(Right, Needle)
843 Grasp(Right, Needle):0	Pull(Left, Needle):9	Touch(Right, Needle):1	 ->Grasp(Right, Needle)
844 Grasp(Right, Needle):0	Pull(Left, Needle):9	Touch(Right, Needle):1	 ->Grasp(Right, Needle)
845 Grasp(Right, Needle):0	Pull(Left, Needle):9	Touch(Right, Needle):1	 ->Grasp(Right, Needle)
846 Grasp(Right, Needle):0	Pull(Left, Needle):9	Touch(Right, Needle):1	 ->Grasp(Right, Needle)
847 Grasp(Right, Needle):0	Pull(Left, Needle):9	Touch(Right, Needle):1	 ->Grasp(Right, Needle)
848 Grasp(Right, Needle):0	Pull(Left, Needle):9	Touch(Right, Needle):1	 ->Grasp(Right, Needle)
849 Grasp(Right, Needle):0	Pull(Left, Needle):9	Touch(Right, Needle):1	 ->Grasp(Right, Needle)
850 Grasp(Right, Needle):0	Pull(Left, Needle):9	Touch(Right, Needle):1	 ->Grasp(Right, Needle)
851 Grasp(Right, Needle):0	Pull(Left, Needle):9	Touch(Right, Needle):1	 ->Grasp(Right, Needle)
852 Grasp(Right, Needle):0	Pull(Left, Needle):9	Touch(Right, Needle):1	 ->Grasp(Right, Needle)
853 Grasp(Right, Needle):0	Pull(Left, Needle):9	Touch(Right, Needle):1	 ->Grasp(Right, Needle)
854 Grasp(Right, Needle):0	Pull(Left, Needle):9	Touch(Right, Needle):1	 ->Grasp(Right, Needle)
855 Grasp(Right, Needle):0	Pull(Left, Needle):9	Grasp(Right, Needle):0	 ->Grasp(Right, Needle)
856 Grasp(Right, Needle):0	Pull(Left, Needle):9	Grasp(Right, Needle):0	 ->Grasp(Right, Needle)
857 Grasp(Right, Needle):0	Pull(Left, Needle):9	Grasp(Right, Needle):0	 ->Grasp(Right, Needle)
858 Grasp(Right, Needle):0	Pull(Left, Needle):9	Grasp(Right, Needle):0	 ->Grasp(Right, Needle)
859 Grasp(Right, Needle):0	Pull(Left, Needle):9	Grasp(Right, Needle):0	 ->Grasp(Right, Needle)
860 Grasp(Right, Needle):0	Pull(Left, Needle):9	Grasp(Right, Needle):0	 ->Grasp(Right, Needle)
861 Grasp(Right, Needle):0	Pull(Left, Needle):9	Grasp(Right, Needle):0	 ->Grasp(Right, Needle)
862 Grasp(Right, Needle):0	Pull(Left, Needle):9	Grasp(Right, Needle):0	 ->Grasp(Right, Needle)
863 Grasp(Right, Needle):0	Pull(Left, Needle):9	Grasp(Right, Needle):0	 ->Grasp(Right, Needle)
864 Grasp(Right, Needle):0	Pull(Left, Needle):9	Grasp(Right, Needle):0	 ->Grasp(Right, Needle)
865 Grasp(Right, Needle):0	Pull(Left, Needle):9	Grasp(Right, Needle):0	 ->Grasp(Right, Needle)
866 Grasp(Right, Needle):0	Pull(Left, Needle):9	Grasp(Right, Needle):0	 ->Grasp(Right, Needle)
867 Grasp(Right, Needle):0	Pull(Left, Needle):9	Release(Left, Needle):6	 ->Grasp(Right, Needle)
868 Grasp(Right, Needle):0	Pull(Left, Needle):9	Release(Left, Needle):6	 ->Grasp(Right, Needle)
869 Grasp(Right, Needle):0	Pull(Left, Needle):9	Release(Left, Needle):6	 ->Grasp(Right, Needle)
870 Grasp(Right, Needle):0	Pull(Left, Needle):9	Release(Left, Needle):6	 ->Grasp(Right, Needle)
871 Grasp(Right, Needle):0	Pull(Left, Needle):9	Release(Left, Needle):6	 ->Grasp(Right, Needle)
872 Grasp(Right, Needle):0	Pull(Left, Needle):9	Release(Left, Needle):6	 ->Grasp(Right, Needle)
873 Grasp(Right, Needle):0	Pull(Left, Needle):9	Release(Left, Needle):6	 ->Grasp(Right, Needle)
874 Grasp(Right, Needle):0	Pull(Left, Needle):9	Release(Left, Needle):6	 ->Grasp(Right, Needle)
875 Untouch(Left, Other):10	Grasp(Right, Needle):0	Release(Left, Needle):6	 ->Untouch(Left, Other)
876 Untouch(Left, Other):10	Grasp(Right, Needle):0	Release(Left, Needle):6	 ->Untouch(Left, Other)
877 Untouch(Left, Other):10	Grasp(Right, Needle):0	Release(Left, Needle):6	 ->Untouch(Left, Other)
878 Untouch(Left, Other):10	Grasp(Right, Needle):0	Untouch(Left, Needle):8	 ->Untouch(Left, Other)
879 Untouch(Left, Other):10	Release(Left, Needle):6	Untouch(Left, Needle):8	 ->Untouch(Left, Other)
880 Untouch(Left, Other):10	Release(Left, Needle):6	Untouch(Left, Needle):8	 ->Untouch(Left, Other)
881 Untouch(Left, Other):10	Release(Left, Needle):6	Untouch(Left, Needle):8	 ->Untouch(Left, Other)
882 Untouch(Left, Other):10	Release(Left, Needle):6	Untouch(Left, Needle):8	 ->Untouch(Left, Other)
883 Untouch(Left, Other):10	Release(Left, Needle):6	Untouch(Left, Needle):8	 ->Untouch(Left, Other)
884 Untouch(Left, Other):10	Release(Left, Needle):6	Untouch(Left, Needle):8	 ->Untouch(Left, Other)
885 Untouch(Left, Other):10	Release(Left, Needle):6	Untouch(Left, Needle):8	 ->Untouch(Left, Other)
886 Untouch(Left, Other):10	Release(Left, Needle):6	Untouch(Left, Needle):8	 ->Untouch(Left, Other)
887 Untouch(Left, Other):10	Release(Left, Needle):6	Untouch(Left, Needle):8	 ->Untouch(Left, Other)
888 Untouch(Left, Other):10	Release(Left, Needle):6	Untouch(Left, Needle):8	 ->Untouch(Left, Other)
889 Untouch(Left, Other):10	Release(Left, Needle):6	Touch(Left, Ring):11	 ->Untouch(Left, Other)
890 Untouch(Left, Other):10	Release(Left, Needle):6	Touch(Left, Ring):11	 ->Untouch(Left, Other)
891 Untouch(Left, Other):10	Release(Left, Needle):6	Touch(Left, Ring):11	 ->Untouch(Left, Other)
892 Untouch(Left, Other):10	Release(Left, Needle):6	Touch(Left, Ring):11	 ->Untouch(Left, Other)
893 Untouch(Left, Other):10	Release(Left, Needle):6	Touch(Left, Ring):11	 ->Untouch(Left, Other)
894 Untouch(Left, Other):10	Release(Left, Needle):6	Touch(Left, Ring):11	 ->Untouch(Left, Other)
895 Untouch(Left, Other):10	Release(Left, Needle):6	Touch(Left, Ring):11	 ->Untouch(Left, Other)
896 Untouch(Left, Other):10	Release(Left, Needle):6	Touch(Left, Ring):11	 ->Untouch(Left, Other)
897 Untouch(Left, Other):10	Release(Left, Needle):6	Touch(Left, Ring):11	 ->Untouch(Left, Other)
898 Untouch(Left, Other):10	Release(Left, Needle):6	Touch(Left, Ring):11	 ->Untouch(Left, Other)
899 Untouch(Left, Other):10	Release(Left, Needle):6	Touch(Left, Ring):11	 ->Untouch(Left, Other)
900 Untouch(Left, Other):10	Release(Left, Needle):6	Touch(Left, Ring):11	 ->Untouch(Left, Other)
901 Untouch(Left, Other):10	Release(Left, Needle):6	Touch(Left, Ring):11	 ->Untouch(Left, Other)
902 Untouch(Left, Other):10	Release(Left, Needle):6	Touch(Left, Ring):11	 ->Untouch(Left, Other)
903 Untouch(Left, Other):10	Release(Left, Needle):6	Touch(Left, Ring):11	 ->Untouch(Left, Other)
904 Untouch(Left, Other):10	Release(Left, Needle):6	Touch(Left, Ring):11	 ->Untouch(Left, Other)
905 Untouch(Left, Other):10	Release(Left, Needle):6	Touch(Left, Ring):11	 ->Untouch(Left, Other)
906 Untouch(Left, Other):10	Release(Left, Needle):6	Touch(Left, Ring):11	 ->Untouch(Left, Other)
907 Untouch(Left, Other):10	Release(Left, Needle):6	Touch(Left, Ring):11	 ->Untouch(Left, Other)
908 Untouch(Left, Other):10	Release(Left, Needle):6	Touch(Left, Ring):11	 ->Untouch(Left, Other)
909 Untouch(Left, Other):10	Release(Left, Needle):6	Touch(Left, Ring):11	 ->Untouch(Left, Other)
910 Untouch(Left, Other):10	Release(Left, Needle):6	Touch(Left, Ring):11	 ->Untouch(Left, Other)
911 Untouch(Left, Other):10	Release(Left, Needle):6	Touch(Left, Ring):11	 ->Untouch(Left, Other)
912 Untouch(Left, Other):10	Release(Left, Needle):6	Touch(Left, Ring):11	 ->Untouch(Left, Other)
913 Untouch(Left, Other):10	Release(Left, Needle):6	Touch(Left, Ring):11	 ->Untouch(Left, Other)
914 Untouch(Left, Other):10	Release(Left, Needle):6	Touch(Left, Ring):11	 ->Untouch(Left, Other)
915 Untouch(Left, Other):10	Release(Left, Needle):6	Touch(Left, Ring):11	 ->Untouch(Left, Other)
916 Untouch(Left, Other):10	Release(Left, Needle):6	Touch(Left, Ring):11	 ->Untouch(Left, Other)
917 Untouch(Left, Other):10	Release(Left, Needle):6	Touch(Left, Ring):11	 ->Untouch(Left, Other)
918 Untouch(Left, Other):10	Release(Left, Needle):6	Touch(Left, Ring):11	 ->Untouch(Left, Other)
919 Untouch(Left, Other):10	Release(Left, Needle):6	Touch(Left, Ring):11	 ->Untouch(Left, Other)
920 Untouch(Left, Other):10	Release(Left, Needle):6	Touch(Left, Ring):11	 ->Untouch(Left, Other)
921 Untouch(Left, Other):10	Release(Left, Needle):6	Touch(Left, Ring):11	 ->Untouch(Left, Other)
922 Untouch(Left, Other):10	Release(Left, Needle):6	Touch(Left, Ring):11	 ->Untouch(Left, Other)
923 Untouch(Left, Other):10	Release(Left, Needle):6	Touch(Left, Ring):11	 ->Untouch(Left, Other)
924 Untouch(Left, Other):10	Release(Left, Needle):6	Touch(Left, Ring):11	 ->Untouch(Left, Other)
925 Untouch(Left, Other):10	Release(Left, Needle):6	Touch(Left, Ring):11	 ->Untouch(Left, Other)
926 Untouch(Left, Other):10	Release(Left, Needle):6	Touch(Left, Ring):11	 ->Untouch(Left, Other)
927 Untouch(Left, Other):10	Release(Left, Needle):6	Touch(Left, Ring):11	 ->Untouch(Left, Other)
928 Untouch(Left, Other):10	Release(Left, Needle):6	Touch(Left, Ring):11	 ->Untouch(Left, Other)
929 Untouch(Left, Other):10	Release(Left, Needle):6	Touch(Left, Ring):11	 ->Untouch(Left, Other)
930 Untouch(Left, Other):10	Release(Left, Needle):6	Touch(Left, Ring):11	 ->Untouch(Left, Other)
931 Untouch(Left, Other):10	Release(Left, Needle):6	Touch(Left, Ring):11	 ->Untouch(Left, Other)
932 Untouch(Left, Other):10	Release(Left, Needle):6	Touch(Left, Ring):11	 ->Untouch(Left, Other)
933 Untouch(Left, Other):10	Release(Left, Needle):6	Touch(Left, Ring):11	 ->Untouch(Left, Other)
934 Untouch(Left, Other):10	Release(Left, Needle):6	Touch(Left, Ring):11	 ->Untouch(Left, Other)
935 Untouch(Left, Other):10	Release(Left, Needle):6	Touch(Left, Ring):11	 ->Untouch(Left, Other)
936 Untouch(Left, Other):10	Release(Left, Needle):6	Touch(Left, Ring):11	 ->Untouch(Left, Other)
937 Untouch(Left, Other):10	Release(Left, Needle):6	Touch(Left, Ring):11	 ->Untouch(Left, Other)
938 Untouch(Left, Other):10	Release(Left, Needle):6	Touch(Left, Ring):11	 ->Untouch(Left, Other)
939 Untouch(Left, Other):10	Release(Left, Needle):6	Touch(Left, Ring):11	 ->Untouch(Left, Other)
940 Untouch(Left, Other):10	Release(Left, Needle):6	Touch(Left, Ring):11	 ->Untouch(Left, Other)
941 Untouch(Left, Other):10	Release(Left, Needle):6	Touch(Left, Ring):11	 ->Untouch(Left, Other)
942 Untouch(Left, Other):10	Release(Left, Needle):6	Touch(Left, Ring):11	 ->Untouch(Left, Other)
943 Untouch(Left, Other):10	Release(Left, Needle):6	Touch(Left, Ring):11	 ->Untouch(Left, Other)
944 Untouch(Left, Other):10	Release(Left, Needle):6	Touch(Left, Ring):11	 ->Untouch(Left, Other)
945 Untouch(Left, Other):10	Release(Left, Needle):6	Touch(Left, Ring):11	 ->Untouch(Left, Other)
946 Untouch(Left, Other):10	Release(Left, Needle):6	Touch(Left, Ring):11	 ->Untouch(Left, Other)
947 Untouch(Left, Other):10	Release(Left, Needle):6	Touch(Left, Ring):11	 ->Untouch(Left, Other)
948 Untouch(Left, Other):10	Release(Left, Needle):6	Touch(Left, Ring):11	 ->Untouch(Left, Other)
949 Untouch(Left, Other):10	Release(Left, Needle):6	Touch(Left, Ring):11	 ->Untouch(Left, Other)
950 Untouch(Left, Other):10	Release(Left, Needle):6	Touch(Left, Ring):11	 ->Untouch(Left, Other)
951 Untouch(Left, Other):10	Release(Left, Needle):6	Touch(Left, Ring):11	 ->Untouch(Left, Other)
952 Untouch(Left, Other):10	Release(Left, Needle):6	Touch(Left, Ring):11	 ->Untouch(Left, Other)
953 Untouch(Left, Other):10	Release(Left, Needle):6	Touch(Left, Ring):11	 ->Untouch(Left, Other)
954 Untouch(Left, Other):10	Release(Left, Needle):6	Touch(Left, Ring):11	 ->Untouch(Left, Other)
955 Untouch(Left, Other):10	Release(Left, Needle):6	Touch(Left, Ring):11	 ->Untouch(Left, Other)
956 Untouch(Left, Other):10	Release(Left, Needle):6	Touch(Left, Ring):11	 ->Untouch(Left, Other)
957 Untouch(Left, Other):10	Release(Left, Needle):6	Touch(Left, Ring):11	 ->Untouch(Left, Other)
958 Untouch(Left, Other):10	Release(Left, Needle):6	Touch(Left, Ring):11	 ->Untouch(Left, Other)
959 Untouch(Left, Other):10	Release(Left, Needle):6	Touch(Left, Ring):11	 ->Untouch(Left, Other)
960 Untouch(Left, Other):10	Release(Left, Needle):6	Touch(Left, Ring):11	 ->Untouch(Left, Other)
961 Untouch(Left, Other):10	Release(Left, Needle):6	Touch(Left, Ring):11	 ->Untouch(Left, Other)
962 Untouch(Left, Other):10	Release(Left, Needle):6	Touch(Left, Ring):11	 ->Untouch(Left, Other)
963 Untouch(Left, Other):10	Release(Left, Needle):6	Touch(Left, Ring):11	 ->Untouch(Left, Other)
964 Untouch(Left, Other):10	Release(Left, Needle):6	Touch(Left, Ring):11	 ->Untouch(Left, Other)
965 Untouch(Left, Other):10	Release(Left, Needle):6	Touch(Left, Ring):11	 ->Untouch(Left, Other)
966 Untouch(Left, Other):10	Release(Left, Needle):6	Touch(Left, Ring):11	 ->Untouch(Left, Other)
967 Untouch(Left, Other):10	Release(Left, Needle):6	Touch(Left, Ring):11	 ->Untouch(Left, Other)
968 Untouch(Left, Other):10	Release(Left, Needle):6	Touch(Left, Ring):11	 ->Untouch(Left, Other)
969 Untouch(Left, Other):10	Release(Left, Needle):6	Touch(Left, Ring):11	 ->Untouch(Left, Other)
970 Untouch(Left, Other):10	Release(Left, Needle):6	Touch(Left, Ring):11	 ->Untouch(Left, Other)
971 Untouch(Left, Other):10	Release(Left, Needle):6	Grasp(Left, Ring):12	 ->Untouch(Left, Other)
972 Untouch(Left, Other):10	Release(Left, Needle):6	Grasp(Left, Ring):12	 ->Untouch(Left, Other)
973 Untouch(Left, Other):10	Release(Left, Needle):6	Grasp(Left, Ring):12	 ->Untouch(Left, Other)
974 Untouch(Left, Other):10	Release(Left, Needle):6	Grasp(Left, Ring):12	 ->Untouch(Left, Other)
975 Untouch(Left, Other):10	Release(Left, Needle):6	Grasp(Left, Ring):12	 ->Untouch(Left, Other)
976 Untouch(Left, Other):10	Release(Left, Needle):6	Grasp(Left, Ring):12	 ->Untouch(Left, Other)
977 Untouch(Left, Other):10	Release(Left, Needle):6	Grasp(Left, Ring):12	 ->Untouch(Left, Other)
978 Untouch(Left, Other):10	Release(Left, Needle):6	Grasp(Left, Ring):12	 ->Untouch(Left, Other)
979 Untouch(Left, Other):10	Release(Left, Needle):6	Grasp(Left, Ring):12	 ->Untouch(Left, Other)
980 Untouch(Left, Other):10	Release(Left, Needle):6	Grasp(Left, Ring):12	 ->Untouch(Left, Other)
981 Untouch(Left, Other):10	Release(Left, Needle):6	Grasp(Left, Ring):12	 ->Untouch(Left, Other)
982 Untouch(Left, Other):10	Release(Left, Needle):6	Grasp(Left, Ring):12	 ->Untouch(Left, Other)
983 Untouch(Left, Other):10	Release(Left, Needle):6	Grasp(Left, Ring):12	 ->Untouch(Left, Other)
984 Untouch(Left, Other):10	Release(Left, Needle):6	Push(Left, Needle):13	 ->Untouch(Left, Other)
985 Untouch(Left, Other):10	Release(Left, Needle):6	Push(Left, Needle):13	 ->Untouch(Left, Other)
986 Untouch(Left, Other):10	Release(Left, Needle):6	Push(Left, Needle):13	 ->Untouch(Left, Other)
987 Push(Right, Needle):7	Release(Left, Needle):6	Push(Left, Needle):13	 ->Push(Right, Needle)
988 Push(Right, Needle):7	Release(Left, Needle):6	Push(Left, Needle):13	 ->Push(Right, Needle)
989 Push(Right, Needle):7	Release(Left, Needle):6	Push(Left, Needle):13	 ->Push(Right, Needle)
990 Push(Right, Needle):7	Release(Left, Needle):6	Push(Left, Needle):13	 ->Push(Right, Needle)
991 Push(Right, Needle):7	Release(Left, Needle):6	Push(Left, Needle):13	 ->Push(Right, Needle)
992 Push(Right, Needle):7	Release(Left, Needle):6	Push(Left, Needle):13	 ->Push(Right, Needle)
993 Push(Right, Needle):7	Release(Left, Needle):6	Push(Left, Needle):13	 ->Push(Right, Needle)
994 Push(Right, Needle):7	Release(Left, Needle):6	Push(Left, Needle):13	 ->Push(Right, Needle)
995 Push(Right, Needle):7	Release(Left, Needle):6	Push(Left, Needle):13	 ->Push(Right, Needle)
996 Push(Right, Needle):7	Release(Left, Needle):6	Push(Left, Needle):13	 ->Push(Right, Needle)
997 Push(Right, Needle):7	Release(Left, Needle):6	Push(Left, Needle):13	 ->Push(Right, Needle)
998 Push(Right, Needle):7	Release(Left, Needle):6	Push(Left, Needle):13	 ->Push(Right, Needle)
999 Push(Right, Needle):7	Grasp(Left, Ring):12	Push(Left, Needle):13	 ->Push(Right, Needle)
1000 Push(Right, Needle):7	Grasp(Left, Ring):12	Push(Left, Needle):13	 ->Push(Right, Needle)
1001 Push(Right, Needle):7	Grasp(Left, Ring):12	Push(Left, Needle):13	 ->Push(Right, Needle)
1002 Push(Right, Needle):7	Grasp(Left, Ring):12	Push(Left, Needle):13	 ->Push(Right, Needle)
1003 Push(Right, Needle):7	Grasp(Left, Ring):12	Push(Left, Needle):13	 ->Push(Right, Needle)
1004 Push(Right, Needle):7	Grasp(Left, Ring):12	Push(Left, Needle):13	 ->Push(Right, Needle)
1005 Push(Right, Needle):7	Grasp(Left, Ring):12	Push(Left, Needle):13	 ->Push(Right, Needle)
1006 Push(Right, Needle):7	Grasp(Left, Ring):12	Push(Left, Needle):13	 ->Push(Right, Needle)
1007 Push(Right, Needle):7	Grasp(Left, Ring):12	Push(Left, Needle):13	 ->Push(Right, Needle)
1008 Push(Right, Needle):7	Grasp(Left, Ring):12	Push(Left, Needle):13	 ->Push(Right, Needle)
1009 Push(Right, Needle):7	Grasp(Left, Ring):12	Push(Left, Needle):13	 ->Push(Right, Needle)
1010 Push(Right, Needle):7	Grasp(Left, Ring):12	Push(Left, Needle):13	 ->Push(Right, Needle)
1011 Push(Right, Needle):7	Grasp(Left, Ring):12	Push(Left, Needle):13	 ->Push(Right, Needle)
1012 Push(Right, Needle):7	Grasp(Left, Ring):12	Push(Left, Needle):13	 ->Push(Right, Needle)
1013 Push(Right, Needle):7	Grasp(Left, Ring):12	Push(Left, Needle):13	 ->Push(Right, Needle)
1014 Push(Right, Needle):7	Grasp(Left, Ring):12	Push(Left, Needle):13	 ->Push(Right, Needle)
1015 Push(Right, Needle):7	Grasp(Left, Ring):12	Push(Left, Needle):13	 ->Push(Right, Needle)
1016 Push(Right, Needle):7	Grasp(Left, Ring):12	Push(Left, Needle):13	 ->Push(Right, Needle)
1017 Push(Right, Needle):7	Grasp(Left, Ring):12	Push(Left, Needle):13	 ->Push(Right, Needle)
1018 Push(Right, Needle):7	Grasp(Left, Ring):12	Push(Left, Needle):13	 ->Push(Right, Needle)
1019 Push(Right, Needle):7	Grasp(Left, Ring):12	Push(Left, Needle):13	 ->Push(Right, Needle)
1020 Push(Right, Needle):7	Grasp(Left, Ring):12	Push(Left, Needle):13	 ->Push(Right, Needle)
1021 Push(Right, Needle):7	Grasp(Left, Ring):12	Push(Left, Needle):13	 ->Push(Right, Needle)
1022 Push(Right, Needle):7	Grasp(Left, Ring):12	Push(Left, Needle):13	 ->Push(Right, Needle)
1023 Push(Right, Needle):7	Grasp(Left, Ring):12	Push(Left, Needle):13	 ->Push(Right, Needle)
1024 Push(Right, Needle):7	Grasp(Left, Ring):12	Push(Left, Needle):13	 ->Push(Right, Needle)
1025 Push(Right, Needle):7	Grasp(Left, Ring):12	Push(Left, Needle):13	 ->Push(Right, Needle)
1026 Push(Right, Needle):7	Grasp(Left, Ring):12	Push(Left, Needle):13	 ->Push(Right, Needle)
1027 Push(Right, Needle):7	Grasp(Left, Ring):12	Push(Left, Needle):13	 ->Push(Right, Needle)
1028 Push(Right, Needle):7	Grasp(Left, Ring):12	Push(Left, Needle):13	 ->Push(Right, Needle)
1029 Push(Right, Needle):7	Grasp(Left, Ring):12	Push(Left, Needle):13	 ->Push(Right, Needle)
1030 Push(Right, Needle):7	Grasp(Left, Ring):12	Push(Left, Needle):13	 ->Push(Right, Needle)
1031 Push(Right, Needle):7	Grasp(Left, Ring):12	Push(Left, Needle):13	 ->Push(Right, Needle)
1032 Push(Right, Needle):7	Grasp(Left, Ring):12	Push(Left, Needle):13	 ->Push(Right, Needle)
1033 Push(Right, Needle):7	Grasp(Left, Ring):12	Push(Left, Needle):13	 ->Push(Right, Needle)
1034 Push(Right, Needle):7	Grasp(Left, Ring):12	Push(Left, Needle):13	 ->Push(Right, Needle)
1035 Push(Right, Needle):7	Grasp(Left, Ring):12	Push(Left, Needle):13	 ->Push(Right, Needle)
1036 Push(Right, Needle):7	Grasp(Left, Ring):12	Push(Left, Needle):13	 ->Push(Right, Needle)
1037 Push(Right, Needle):7	Grasp(Left, Ring):12	Push(Left, Needle):13	 ->Push(Right, Needle)
1038 Push(Right, Needle):7	Grasp(Left, Ring):12	Push(Left, Needle):13	 ->Push(Right, Needle)
1039 Push(Right, Needle):7	Grasp(Left, Ring):12	Push(Left, Needle):13	 ->Push(Right, Needle)
1040 Push(Right, Needle):7	Grasp(Left, Ring):12	Push(Left, Needle):13	 ->Push(Right, Needle)
1041 Push(Right, Needle):7	Grasp(Left, Ring):12	Push(Left, Needle):13	 ->Push(Right, Needle)
1042 Push(Right, Needle):7	Grasp(Left, Ring):12	Push(Left, Needle):13	 ->Push(Right, Needle)
1043 Push(Right, Needle):7	Grasp(Left, Ring):12	Push(Left, Needle):13	 ->Push(Right, Needle)
1044 Push(Right, Needle):7	Grasp(Left, Ring):12	Push(Left, Needle):13	 ->Push(Right, Needle)
1045 Push(Right, Needle):7	Grasp(Left, Ring):12	Push(Left, Needle):13	 ->Push(Right, Needle)
1046 Push(Right, Needle):7	Grasp(Left, Ring):12	Push(Left, Needle):13	 ->Push(Right, Needle)
1047 Push(Right, Needle):7	Grasp(Left, Ring):12	Push(Left, Needle):13	 ->Push(Right, Needle)
1048 Push(Right, Needle):7	Grasp(Left, Ring):12	Push(Left, Needle):13	 ->Push(Right, Needle)
1049 Push(Right, Needle):7	Grasp(Left, Ring):12	Push(Left, Needle):13	 ->Push(Right, Needle)
1050 Push(Right, Needle):7	Grasp(Left, Ring):12	Push(Left, Needle):13	 ->Push(Right, Needle)
1051 Push(Right, Needle):7	Grasp(Left, Ring):12	Push(Left, Needle):13	 ->Push(Right, Needle)
1052 Push(Right, Needle):7	Grasp(Left, Ring):12	Push(Left, Needle):13	 ->Push(Right, Needle)
1053 Push(Right, Needle):7	Grasp(Left, Ring):12	Push(Left, Needle):13	 ->Push(Right, Needle)
1054 Push(Right, Needle):7	Grasp(Left, Ring):12	Push(Left, Needle):13	 ->Push(Right, Needle)
1055 Push(Right, Needle):7	Grasp(Left, Ring):12	Push(Left, Needle):13	 ->Push(Right, Needle)
1056 Push(Right, Needle):7	Grasp(Left, Ring):12	Push(Left, Needle):13	 ->Push(Right, Needle)
1057 Push(Right, Needle):7	Grasp(Left, Ring):12	Push(Left, Needle):13	 ->Push(Right, Needle)
1058 Push(Right, Needle):7	Grasp(Left, Ring):12	Push(Left, Needle):13	 ->Push(Right, Needle)
1059 Push(Right, Needle):7	Grasp(Left, Ring):12	Push(Left, Needle):13	 ->Push(Right, Needle)
1060 Push(Right, Needle):7	Grasp(Left, Ring):12	Push(Left, Needle):13	 ->Push(Right, Needle)
1061 Push(Right, Needle):7	Grasp(Left, Ring):12	Push(Left, Needle):13	 ->Push(Right, Needle)
1062 Push(Right, Needle):7	Grasp(Left, Ring):12	Push(Left, Needle):13	 ->Push(Right, Needle)
1063 Push(Right, Needle):7	Grasp(Left, Ring):12	Push(Left, Needle):13	 ->Push(Right, Needle)
1064 Push(Right, Needle):7	Grasp(Left, Ring):12	Push(Left, Needle):13	 ->Push(Right, Needle)
1065 Push(Right, Needle):7	Grasp(Left, Ring):12	Push(Left, Needle):13	 ->Push(Right, Needle)
1066 Push(Right, Needle):7	Push(Right, Needle):7	Push(Left, Needle):13	 ->Push(Right, Needle)
1067 Push(Right, Needle):7	Push(Right, Needle):7	Push(Left, Needle):13	 ->Push(Right, Needle)
1068 Push(Right, Needle):7	Push(Right, Needle):7	Push(Left, Needle):13	 ->Push(Right, Needle)
1069 Push(Right, Needle):7	Push(Right, Needle):7	Push(Left, Needle):13	 ->Push(Right, Needle)
1070 Push(Right, Needle):7	Push(Right, Needle):7	Push(Left, Needle):13	 ->Push(Right, Needle)
1071 Push(Right, Needle):7	Push(Right, Needle):7	Push(Left, Needle):13	 ->Push(Right, Needle)
1072 Push(Right, Needle):7	Push(Right, Needle):7	Push(Left, Needle):13	 ->Push(Right, Needle)
1073 Push(Right, Needle):7	Push(Right, Needle):7	Push(Left, Needle):13	 ->Push(Right, Needle)
1074 Push(Right, Needle):7	Push(Right, Needle):7	Push(Left, Needle):13	 ->Push(Right, Needle)
1075 Push(Right, Needle):7	Push(Right, Needle):7	Push(Left, Needle):13	 ->Push(Right, Needle)
1076 Push(Right, Needle):7	Push(Right, Needle):7	Push(Left, Needle):13	 ->Push(Right, Needle)
1077 Push(Right, Needle):7	Push(Right, Needle):7	Push(Left, Needle):13	 ->Push(Right, Needle)
1078 Push(Right, Needle):7	Push(Right, Needle):7	Push(Left, Needle):13	 ->Push(Right, Needle)
1079 Push(Right, Needle):7	Push(Right, Needle):7	Push(Left, Needle):13	 ->Push(Right, Needle)
1080 Push(Right, Needle):7	Push(Right, Needle):7	Push(Left, Needle):13	 ->Push(Right, Needle)
1081 Push(Right, Needle):7	Push(Right, Needle):7	Push(Left, Needle):13	 ->Push(Right, Needle)
1082 Push(Right, Needle):7	Push(Right, Needle):7	Push(Left, Needle):13	 ->Push(Right, Needle)
1083 Push(Right, Needle):7	Push(Right, Needle):7	Push(Left, Needle):13	 ->Push(Right, Needle)
1084 Push(Right, Needle):7	Push(Right, Needle):7	Push(Left, Needle):13	 ->Push(Right, Needle)
1085 Push(Right, Needle):7	Push(Right, Needle):7	Push(Left, Needle):13	 ->Push(Right, Needle)
1086 Push(Right, Needle):7	Push(Right, Needle):7	Push(Left, Needle):13	 ->Push(Right, Needle)
1087 Push(Right, Needle):7	Push(Right, Needle):7	Push(Left, Needle):13	 ->Push(Right, Needle)
1088 Push(Right, Needle):7	Push(Right, Needle):7	Push(Left, Needle):13	 ->Push(Right, Needle)
1089 Push(Right, Needle):7	Push(Right, Needle):7	Push(Left, Needle):13	 ->Push(Right, Needle)
1090 Push(Right, Needle):7	Push(Right, Needle):7	Push(Left, Needle):13	 ->Push(Right, Needle)
1091 Push(Right, Needle):7	Push(Right, Needle):7	Push(Left, Needle):13	 ->Push(Right, Needle)
1092 Push(Right, Needle):7	Push(Right, Needle):7	Push(Left, Needle):13	 ->Push(Right, Needle)
1093 Push(Right, Needle):7	Push(Right, Needle):7	Push(Left, Needle):13	 ->Push(Right, Needle)
1094 Push(Right, Needle):7	Push(Right, Needle):7	Push(Left, Needle):13	 ->Push(Right, Needle)
1095 Push(Right, Needle):7	Push(Right, Needle):7	Push(Left, Needle):13	 ->Push(Right, Needle)
1096 Push(Right, Needle):7	Push(Right, Needle):7	Push(Left, Needle):13	 ->Push(Right, Needle)
1097 Push(Right, Needle):7	Push(Right, Needle):7	Push(Left, Needle):13	 ->Push(Right, Needle)
1098 Push(Right, Needle):7	Push(Right, Needle):7	Push(Left, Needle):13	 ->Push(Right, Needle)
1099 Push(Right, Needle):7	Push(Right, Needle):7	Push(Left, Needle):13	 ->Push(Right, Needle)
1100 Push(Right, Needle):7	Push(Right, Needle):7	Push(Left, Needle):13	 ->Push(Right, Needle)
1101 Push(Right, Needle):7	Push(Right, Needle):7	Release(Left, Ring):14	 ->Push(Right, Needle)
1102 Push(Right, Needle):7	Push(Right, Needle):7	Release(Left, Ring):14	 ->Push(Right, Needle)
1103 Push(Right, Needle):7	Push(Right, Needle):7	Release(Left, Ring):14	 ->Push(Right, Needle)
1104 Push(Right, Needle):7	Release(Left, Ring):14	Release(Left, Ring):14	 ->Release(Left, Ring)
1105 Push(Right, Needle):7	Release(Left, Ring):14	Release(Left, Ring):14	 ->Release(Left, Ring)
1106 Push(Right, Needle):7	Release(Left, Ring):14	Release(Left, Ring):14	 ->Release(Left, Ring)
1107 Push(Right, Needle):7	Release(Left, Ring):14	Touch(Left, Needle):4	 ->Push(Right, Needle)
1108 Push(Right, Needle):7	Release(Left, Ring):14	Touch(Left, Needle):4	 ->Push(Right, Needle)
1109 Push(Right, Needle):7	Release(Left, Ring):14	Touch(Left, Needle):4	 ->Push(Right, Needle)
1110 Push(Right, Needle):7	Release(Left, Ring):14	Touch(Left, Needle):4	 ->Push(Right, Needle)
1111 Push(Right, Needle):7	Release(Left, Ring):14	Touch(Left, Needle):4	 ->Push(Right, Needle)
1112 Push(Right, Needle):7	Release(Left, Ring):14	Touch(Left, Needle):4	 ->Push(Right, Needle)
1113 Push(Right, Needle):7	Release(Left, Ring):14	Touch(Left, Needle):4	 ->Push(Right, Needle)
1114 Push(Right, Needle):7	Release(Left, Ring):14	Touch(Left, Needle):4	 ->Push(Right, Needle)
1115 Push(Right, Needle):7	Release(Left, Ring):14	Touch(Left, Needle):4	 ->Push(Right, Needle)
1116 Push(Right, Needle):7	Release(Left, Ring):14	Touch(Left, Needle):4	 ->Push(Right, Needle)
1117 Push(Right, Needle):7	Release(Left, Ring):14	Touch(Left, Needle):4	 ->Push(Right, Needle)
1118 Push(Right, Needle):7	Release(Left, Ring):14	Touch(Left, Needle):4	 ->Push(Right, Needle)
1119 Push(Right, Needle):7	Release(Left, Ring):14	Touch(Left, Needle):4	 ->Push(Right, Needle)
1120 Push(Right, Needle):7	Release(Left, Ring):14	Touch(Left, Needle):4	 ->Push(Right, Needle)
1121 Push(Right, Needle):7	Release(Left, Ring):14	Touch(Left, Needle):4	 ->Push(Right, Needle)
1122 Push(Right, Needle):7	Release(Left, Ring):14	Touch(Left, Needle):4	 ->Push(Right, Needle)
1123 Push(Right, Needle):7	Release(Left, Ring):14	Touch(Left, Needle):4	 ->Push(Right, Needle)
1124 Push(Right, Needle):7	Release(Left, Ring):14	Touch(Left, Needle):4	 ->Push(Right, Needle)
1125 Push(Right, Needle):7	Release(Left, Ring):14	Touch(Left, Needle):4	 ->Push(Right, Needle)
1126 Push(Right, Needle):7	Release(Left, Ring):14	Touch(Left, Needle):4	 ->Push(Right, Needle)
1127 Push(Right, Needle):7	Release(Left, Ring):14	Touch(Left, Needle):4	 ->Push(Right, Needle)
1128 Push(Right, Needle):7	Release(Left, Ring):14	Touch(Left, Needle):4	 ->Push(Right, Needle)
1129 Push(Right, Needle):7	Release(Left, Ring):14	Touch(Left, Needle):4	 ->Push(Right, Needle)
1130 Push(Right, Needle):7	Grasp(Left, Needle):5	Touch(Left, Needle):4	 ->Push(Right, Needle)
1131 Push(Right, Needle):7	Grasp(Left, Needle):5	Touch(Left, Needle):4	 ->Push(Right, Needle)
1132 Push(Right, Needle):7	Grasp(Left, Needle):5	Touch(Left, Needle):4	 ->Push(Right, Needle)
1133 Push(Right, Needle):7	Grasp(Left, Needle):5	Touch(Left, Needle):4	 ->Push(Right, Needle)
1134 Touch(Left, Needle):4	Grasp(Left, Needle):5	Touch(Left, Needle):4	 ->Touch(Left, Needle)
1135 Touch(Left, Needle):4	Grasp(Left, Needle):5	Touch(Left, Needle):4	 ->Touch(Left, Needle)
1136 Touch(Left, Needle):4	Grasp(Left, Needle):5	Touch(Left, Needle):4	 ->Touch(Left, Needle)
1137 Touch(Left, Needle):4	Grasp(Left, Needle):5	Touch(Left, Needle):4	 ->Touch(Left, Needle)
1138 Touch(Left, Needle):4	Grasp(Left, Needle):5	Touch(Left, Needle):4	 ->Touch(Left, Needle)
1139 Touch(Left, Needle):4	Grasp(Left, Needle):5	Touch(Left, Needle):4	 ->Touch(Left, Needle)
1140 Touch(Left, Needle):4	Grasp(Left, Needle):5	Touch(Left, Needle):4	 ->Touch(Left, Needle)
1141 Touch(Left, Needle):4	Grasp(Left, Needle):5	Touch(Left, Needle):4	 ->Touch(Left, Needle)
1142 Touch(Left, Needle):4	Grasp(Left, Needle):5	Touch(Left, Needle):4	 ->Touch(Left, Needle)
1143 Touch(Left, Needle):4	Grasp(Left, Needle):5	Touch(Left, Needle):4	 ->Touch(Left, Needle)
1144 Touch(Left, Needle):4	Grasp(Left, Needle):5	Touch(Left, Needle):4	 ->Touch(Left, Needle)
1145 Touch(Left, Needle):4	Grasp(Left, Needle):5	Grasp(Left, Needle):5	 ->Grasp(Left, Needle)
1146 Touch(Left, Needle):4	Grasp(Left, Needle):5	Grasp(Left, Needle):5	 ->Grasp(Left, Needle)
1147 Touch(Left, Needle):4	Grasp(Left, Needle):5	Grasp(Left, Needle):5	 ->Grasp(Left, Needle)
1148 Touch(Left, Needle):4	Grasp(Left, Needle):5	Grasp(Left, Needle):5	 ->Grasp(Left, Needle)
1149 Touch(Left, Needle):4	Grasp(Left, Needle):5	Grasp(Left, Needle):5	 ->Grasp(Left, Needle)
1150 Touch(Left, Needle):4	Grasp(Left, Needle):5	Grasp(Left, Needle):5	 ->Grasp(Left, Needle)
1151 Touch(Left, Needle):4	Grasp(Left, Needle):5	Grasp(Left, Needle):5	 ->Grasp(Left, Needle)
1152 Touch(Left, Needle):4	Grasp(Left, Needle):5	Grasp(Left, Needle):5	 ->Grasp(Left, Needle)
1153 Touch(Left, Needle):4	Grasp(Left, Needle):5	Grasp(Left, Needle):5	 ->Grasp(Left, Needle)
1154 Touch(Left, Needle):4	Grasp(Left, Needle):5	Grasp(Left, Needle):5	 ->Grasp(Left, Needle)
1155 Touch(Left, Needle):4	Grasp(Left, Needle):5	Grasp(Left, Needle):5	 ->Grasp(Left, Needle)
1156 Touch(Left, Needle):4	Grasp(Left, Needle):5	Grasp(Left, Needle):5	 ->Grasp(Left, Needle)
1157 Touch(Left, Needle):4	Grasp(Left, Needle):5	Release(Right, Needle):2	 ->Touch(Left, Needle)
1158 Touch(Left, Needle):4	Grasp(Left, Needle):5	Release(Right, Needle):2	 ->Touch(Left, Needle)
1159 Touch(Left, Needle):4	Grasp(Left, Needle):5	Release(Right, Needle):2	 ->Touch(Left, Needle)
1160 Touch(Left, Needle):4	Grasp(Left, Needle):5	Release(Right, Needle):2	 ->Touch(Left, Needle)
1161 Touch(Left, Needle):4	Grasp(Left, Needle):5	Release(Right, Needle):2	 ->Touch(Left, Needle)
1162 Touch(Left, Needle):4	Grasp(Left, Needle):5	Release(Right, Needle):2	 ->Touch(Left, Needle)
1163 Touch(Left, Needle):4	Grasp(Left, Needle):5	Release(Right, Needle):2	 ->Touch(Left, Needle)
1164 Grasp(Left, Needle):5	Pull(Left, Needle):9	Pull(Left, Needle):9	 ->Pull(Left, Needle)
1165 Grasp(Left, Needle):5	Pull(Left, Needle):9	Pull(Left, Needle):9	 ->Pull(Left, Needle)
1166 Grasp(Left, Needle):5	Pull(Left, Needle):9	Pull(Left, Needle):9	 ->Pull(Left, Needle)
1167 Grasp(Left, Needle):5	Pull(Left, Needle):9	Pull(Left, Needle):9	 ->Pull(Left, Needle)
1168 Grasp(Left, Needle):5	Pull(Left, Needle):9	Pull(Left, Needle):9	 ->Pull(Left, Needle)
1169 Grasp(Left, Needle):5	Pull(Left, Needle):9	Pull(Left, Needle):9	 ->Pull(Left, Needle)
1170 Grasp(Left, Needle):5	Pull(Left, Needle):9	Pull(Left, Needle):9	 ->Pull(Left, Needle)
1171 Grasp(Left, Needle):5	Pull(Left, Needle):9	Pull(Left, Needle):9	 ->Pull(Left, Needle)
1172 Grasp(Left, Needle):5	Pull(Left, Needle):9	Pull(Left, Needle):9	 ->Pull(Left, Needle)
1173 Grasp(Left, Needle):5	Pull(Left, Needle):9	Pull(Left, Needle):9	 ->Pull(Left, Needle)
1174 Grasp(Left, Needle):5	Pull(Left, Needle):9	Pull(Left, Needle):9	 ->Pull(Left, Needle)
1175 Grasp(Left, Needle):5	Pull(Left, Needle):9	Pull(Left, Needle):9	 ->Pull(Left, Needle)
1176 Grasp(Left, Needle):5	Pull(Left, Needle):9	Pull(Left, Needle):9	 ->Pull(Left, Needle)
1177 Grasp(Left, Needle):5	Pull(Left, Needle):9	Pull(Left, Needle):9	 ->Pull(Left, Needle)
1178 Grasp(Left, Needle):5	Pull(Left, Needle):9	Pull(Left, Needle):9	 ->Pull(Left, Needle)
1179 Grasp(Left, Needle):5	Pull(Left, Needle):9	Pull(Left, Needle):9	 ->Pull(Left, Needle)
1180 Grasp(Left, Needle):5	Pull(Left, Needle):9	Pull(Left, Needle):9	 ->Pull(Left, Needle)
1181 Grasp(Left, Needle):5	Pull(Left, Needle):9	Pull(Left, Needle):9	 ->Pull(Left, Needle)
1182 Pull(Left, Needle):9	Pull(Left, Needle):9	Pull(Left, Needle):9	 ->Pull(Left, Needle)
1183 Pull(Left, Needle):9	Pull(Left, Needle):9	Pull(Left, Needle):9	 ->Pull(Left, Needle)
1184 Pull(Left, Needle):9	Pull(Left, Needle):9	Pull(Left, Needle):9	 ->Pull(Left, Needle)
1185 Pull(Left, Needle):9	Pull(Left, Needle):9	Pull(Left, Needle):9	 ->Pull(Left, Needle)
1186 Pull(Left, Needle):9	Pull(Left, Needle):9	Pull(Left, Needle):9	 ->Pull(Left, Needle)
1187 Pull(Left, Needle):9	Pull(Left, Needle):9	Pull(Left, Needle):9	 ->Pull(Left, Needle)
1188 Pull(Left, Needle):9	Pull(Left, Needle):9	Pull(Left, Needle):9	 ->Pull(Left, Needle)
1189 Pull(Left, Needle):9	Pull(Left, Needle):9	Pull(Left, Needle):9	 ->Pull(Left, Needle)
1190 Pull(Left, Needle):9	Pull(Left, Needle):9	Pull(Left, Needle):9	 ->Pull(Left, Needle)
1191 Pull(Left, Needle):9	Pull(Left, Needle):9	Pull(Left, Needle):9	 ->Pull(Left, Needle)
1192 Pull(Left, Needle):9	Pull(Left, Needle):9	Pull(Left, Needle):9	 ->Pull(Left, Needle)
1193 Pull(Left, Needle):9	Pull(Left, Needle):9	Pull(Left, Needle):9	 ->Pull(Left, Needle)
1194 Pull(Left, Needle):9	Pull(Left, Needle):9	Touch(Right, Needle):1	 ->Pull(Left, Needle)
1195 Pull(Left, Needle):9	Pull(Left, Needle):9	Touch(Right, Needle):1	 ->Pull(Left, Needle)
1196 Pull(Left, Needle):9	Pull(Left, Needle):9	Touch(Right, Needle):1	 ->Pull(Left, Needle)
1197 Pull(Left, Needle):9	Pull(Left, Needle):9	Touch(Right, Needle):1	 ->Pull(Left, Needle)
1198 Pull(Left, Needle):9	Pull(Left, Needle):9	Touch(Right, Needle):1	 ->Pull(Left, Needle)
1199 Pull(Left, Needle):9	Pull(Left, Needle):9	Touch(Right, Needle):1	 ->Pull(Left, Needle)
1200 Pull(Left, Needle):9	Pull(Left, Needle):9	Touch(Right, Needle):1	 ->Pull(Left, Needle)
1201 Pull(Left, Needle):9	Pull(Left, Needle):9	Touch(Right, Needle):1	 ->Pull(Left, Needle)
1202 Pull(Left, Needle):9	Pull(Left, Needle):9	Touch(Right, Needle):1	 ->Pull(Left, Needle)
1203 Pull(Left, Needle):9	Pull(Left, Needle):9	Touch(Right, Needle):1	 ->Pull(Left, Needle)
1204 Pull(Left, Needle):9	Pull(Left, Needle):9	Touch(Right, Needle):1	 ->Pull(Left, Needle)
1205 Pull(Left, Needle):9	Pull(Left, Needle):9	Touch(Right, Needle):1	 ->Pull(Left, Needle)
1206 Pull(Left, Needle):9	Pull(Left, Needle):9	Touch(Right, Needle):1	 ->Pull(Left, Needle)
1207 Pull(Left, Needle):9	Pull(Left, Needle):9	Touch(Right, Needle):1	 ->Pull(Left, Needle)
1208 Pull(Left, Needle):9	Pull(Left, Needle):9	Touch(Right, Needle):1	 ->Pull(Left, Needle)
1209 Pull(Left, Needle):9	Pull(Left, Needle):9	Touch(Right, Needle):1	 ->Pull(Left, Needle)
1210 Pull(Left, Needle):9	Pull(Left, Needle):9	Touch(Right, Needle):1	 ->Pull(Left, Needle)
1211 Pull(Left, Needle):9	Pull(Left, Needle):9	Touch(Right, Needle):1	 ->Pull(Left, Needle)
1212 Pull(Left, Needle):9	Pull(Left, Needle):9	Touch(Right, Needle):1	 ->Pull(Left, Needle)
1213 Pull(Left, Needle):9	Pull(Left, Needle):9	Touch(Right, Needle):1	 ->Pull(Left, Needle)
1214 Pull(Left, Needle):9	Pull(Left, Needle):9	Touch(Right, Needle):1	 ->Pull(Left, Needle)
1215 Pull(Left, Needle):9	Pull(Left, Needle):9	Touch(Right, Needle):1	 ->Pull(Left, Needle)
1216 Grasp(Right, Needle):0	Pull(Left, Needle):9	Touch(Right, Needle):1	 ->Grasp(Right, Needle)
1217 Grasp(Right, Needle):0	Pull(Left, Needle):9	Touch(Right, Needle):1	 ->Grasp(Right, Needle)
1218 Grasp(Right, Needle):0	Pull(Left, Needle):9	Touch(Right, Needle):1	 ->Grasp(Right, Needle)
1219 Grasp(Right, Needle):0	Pull(Left, Needle):9	Touch(Right, Needle):1	 ->Grasp(Right, Needle)
1220 Grasp(Right, Needle):0	Pull(Left, Needle):9	Touch(Right, Needle):1	 ->Grasp(Right, Needle)
1221 Grasp(Right, Needle):0	Pull(Left, Needle):9	Touch(Right, Needle):1	 ->Grasp(Right, Needle)
1222 Grasp(Right, Needle):0	Pull(Left, Needle):9	Touch(Right, Needle):1	 ->Grasp(Right, Needle)
1223 Grasp(Right, Needle):0	Pull(Left, Needle):9	Touch(Right, Needle):1	 ->Grasp(Right, Needle)
1224 Grasp(Right, Needle):0	Pull(Left, Needle):9	Touch(Right, Needle):1	 ->Grasp(Right, Needle)
1225 Grasp(Right, Needle):0	Pull(Left, Needle):9	Touch(Right, Needle):1	 ->Grasp(Right, Needle)
1226 Grasp(Right, Needle):0	Pull(Left, Needle):9	Touch(Right, Needle):1	 ->Grasp(Right, Needle)
1227 Grasp(Right, Needle):0	Pull(Left, Needle):9	Touch(Right, Needle):1	 ->Grasp(Right, Needle)
1228 Grasp(Right, Needle):0	Pull(Left, Needle):9	Touch(Right, Needle):1	 ->Grasp(Right, Needle)
1229 Grasp(Right, Needle):0	Pull(Left, Needle):9	Touch(Right, Needle):1	 ->Grasp(Right, Needle)
1230 Grasp(Right, Needle):0	Pull(Left, Needle):9	Touch(Right, Needle):1	 ->Grasp(Right, Needle)
1231 Grasp(Right, Needle):0	Pull(Left, Needle):9	Touch(Right, Needle):1	 ->Grasp(Right, Needle)
1232 Grasp(Right, Needle):0	Pull(Left, Needle):9	Touch(Right, Needle):1	 ->Grasp(Right, Needle)
1233 Grasp(Right, Needle):0	Pull(Left, Needle):9	Touch(Right, Needle):1	 ->Grasp(Right, Needle)
1234 Grasp(Right, Needle):0	Pull(Left, Needle):9	Touch(Right, Needle):1	 ->Grasp(Right, Needle)
1235 Grasp(Right, Needle):0	Pull(Left, Needle):9	Touch(Right, Needle):1	 ->Grasp(Right, Needle)
1236 Grasp(Right, Needle):0	Pull(Left, Needle):9	Touch(Right, Needle):1	 ->Grasp(Right, Needle)
1237 Grasp(Right, Needle):0	Pull(Left, Needle):9	Touch(Right, Needle):1	 ->Grasp(Right, Needle)
1238 Grasp(Right, Needle):0	Pull(Left, Needle):9	Touch(Right, Needle):1	 ->Grasp(Right, Needle)
1239 Grasp(Right, Needle):0	Pull(Left, Needle):9	Touch(Right, Needle):1	 ->Grasp(Right, Needle)
1240 Grasp(Right, Needle):0	Pull(Left, Needle):9	Touch(Right, Needle):1	 ->Grasp(Right, Needle)
1241 Grasp(Right, Needle):0	Pull(Left, Needle):9	Touch(Right, Needle):1	 ->Grasp(Right, Needle)
1242 Grasp(Right, Needle):0	Pull(Left, Needle):9	Touch(Right, Needle):1	 ->Grasp(Right, Needle)
1243 Grasp(Right, Needle):0	Pull(Left, Needle):9	Touch(Right, Needle):1	 ->Grasp(Right, Needle)
1244 Grasp(Right, Needle):0	Pull(Left, Needle):9	Touch(Right, Needle):1	 ->Grasp(Right, Needle)
1245 Grasp(Right, Needle):0	Pull(Left, Needle):9	Touch(Right, Needle):1	 ->Grasp(Right, Needle)
1246 Grasp(Right, Needle):0	Pull(Left, Needle):9	Touch(Right, Needle):1	 ->Grasp(Right, Needle)
1247 Grasp(Right, Needle):0	Pull(Left, Needle):9	Grasp(Right, Needle):0	 ->Grasp(Right, Needle)
1248 Grasp(Right, Needle):0	Pull(Left, Needle):9	Grasp(Right, Needle):0	 ->Grasp(Right, Needle)
1249 Grasp(Right, Needle):0	Pull(Left, Needle):9	Grasp(Right, Needle):0	 ->Grasp(Right, Needle)
1250 Grasp(Right, Needle):0	Pull(Left, Needle):9	Grasp(Right, Needle):0	 ->Grasp(Right, Needle)
1251 Grasp(Right, Needle):0	Pull(Left, Needle):9	Grasp(Right, Needle):0	 ->Grasp(Right, Needle)
1252 Grasp(Right, Needle):0	Pull(Left, Needle):9	Grasp(Right, Needle):0	 ->Grasp(Right, Needle)
1253 Grasp(Right, Needle):0	Pull(Left, Needle):9	Grasp(Right, Needle):0	 ->Grasp(Right, Needle)
1254 Grasp(Right, Needle):0	Pull(Left, Needle):9	Grasp(Right, Needle):0	 ->Grasp(Right, Needle)
1255 Grasp(Right, Needle):0	Pull(Left, Needle):9	Grasp(Right, Needle):0	 ->Grasp(Right, Needle)
1256 Grasp(Right, Needle):0	Pull(Left, Needle):9	Grasp(Right, Needle):0	 ->Grasp(Right, Needle)
1257 Grasp(Right, Needle):0	Pull(Left, Needle):9	Grasp(Right, Needle):0	 ->Grasp(Right, Needle)
1258 Grasp(Right, Needle):0	Pull(Left, Needle):9	Grasp(Right, Needle):0	 ->Grasp(Right, Needle)
1259 Grasp(Right, Needle):0	Pull(Left, Needle):9	Grasp(Right, Needle):0	 ->Grasp(Right, Needle)
1260 Grasp(Right, Needle):0	Pull(Left, Needle):9	Grasp(Right, Needle):0	 ->Grasp(Right, Needle)
1261 Grasp(Right, Needle):0	Pull(Left, Needle):9	Grasp(Right, Needle):0	 ->Grasp(Right, Needle)
1262 Grasp(Right, Needle):0	Pull(Left, Needle):9	Grasp(Right, Needle):0	 ->Grasp(Right, Needle)
1263 Grasp(Right, Needle):0	Pull(Left, Needle):9	Grasp(Right, Needle):0	 ->Grasp(Right, Needle)
1264 Grasp(Right, Needle):0	Pull(Left, Needle):9	Grasp(Right, Needle):0	 ->Grasp(Right, Needle)
1265 Grasp(Right, Needle):0	Grasp(Right, Needle):0	Grasp(Right, Needle):0	 ->Grasp(Right, Needle)
1266 Grasp(Right, Needle):0	Grasp(Right, Needle):0	Grasp(Right, Needle):0	 ->Grasp(Right, Needle)
1267 Grasp(Right, Needle):0	Grasp(Right, Needle):0	Release(Left, Needle):6	 ->Grasp(Right, Needle)
1268 Grasp(Right, Needle):0	Grasp(Right, Needle):0	Release(Left, Needle):6	 ->Grasp(Right, Needle)
1269 Grasp(Right, Needle):0	Grasp(Right, Needle):0	Release(Left, Needle):6	 ->Grasp(Right, Needle)
1270 Grasp(Right, Needle):0	Grasp(Right, Needle):0	Release(Left, Needle):6	 ->Grasp(Right, Needle)
1271 Grasp(Right, Needle):0	Grasp(Right, Needle):0	Release(Left, Needle):6	 ->Grasp(Right, Needle)
1272 Grasp(Right, Needle):0	Release(Left, Needle):6	Untouch(Left, Needle):8	 ->Grasp(Right, Needle)
1273 Grasp(Right, Needle):0	Release(Left, Needle):6	Untouch(Left, Needle):8	 ->Grasp(Right, Needle)
1274 Grasp(Right, Needle):0	Release(Left, Needle):6	Untouch(Left, Needle):8	 ->Grasp(Right, Needle)
1275 Grasp(Right, Needle):0	Release(Left, Needle):6	Untouch(Left, Needle):8	 ->Grasp(Right, Needle)
1276 Grasp(Right, Needle):0	Grasp(Left, Ring):12	Untouch(Left, Needle):8	 ->Grasp(Right, Needle)
1277 Grasp(Right, Needle):0	Grasp(Left, Ring):12	Untouch(Left, Needle):8	 ->Grasp(Right, Needle)
1278 Grasp(Right, Needle):0	Grasp(Left, Ring):12	Untouch(Left, Needle):8	 ->Grasp(Right, Needle)
1279 Grasp(Right, Needle):0	Grasp(Left, Ring):12	Untouch(Left, Needle):8	 ->Grasp(Right, Needle)
1280 Grasp(Left, Other):15	Grasp(Left, Ring):12	Untouch(Left, Needle):8	 ->Grasp(Left, Other)
1281 Grasp(Left, Other):15	Grasp(Left, Ring):12	Untouch(Left, Needle):8	 ->Grasp(Left, Other)
1282 Grasp(Left, Other):15	Grasp(Left, Ring):12	Untouch(Left, Needle):8	 ->Grasp(Left, Other)
1283 Grasp(Left, Other):15	Grasp(Left, Ring):12	Untouch(Left, Needle):8	 ->Grasp(Left, Other)
1284 Grasp(Left, Other):15	Grasp(Left, Ring):12	Untouch(Left, Needle):8	 ->Grasp(Left, Other)
1285 Grasp(Left, Other):15	Grasp(Left, Ring):12	Untouch(Left, Needle):8	 ->Grasp(Left, Other)
1286 Grasp(Left, Other):15	Grasp(Left, Ring):12	Untouch(Left, Needle):8	 ->Grasp(Left, Other)
1287 Grasp(Left, Other):15	Grasp(Left, Ring):12	Untouch(Left, Needle):8	 ->Grasp(Left, Other)
1288 Grasp(Left, Other):15	Grasp(Left, Ring):12	Touch(Left, Ring):11	 ->Grasp(Left, Other)
1289 Grasp(Left, Other):15	Grasp(Left, Ring):12	Touch(Left, Ring):11	 ->Grasp(Left, Other)
1290 Grasp(Left, Other):15	Grasp(Left, Ring):12	Touch(Left, Ring):11	 ->Grasp(Left, Other)
1291 Grasp(Left, Other):15	Grasp(Left, Ring):12	Touch(Left, Ring):11	 ->Grasp(Left, Other)
1292 Grasp(Left, Other):15	Grasp(Left, Ring):12	Touch(Left, Ring):11	 ->Grasp(Left, Other)
1293 Grasp(Left, Other):15	Grasp(Left, Ring):12	Touch(Left, Ring):11	 ->Grasp(Left, Other)
1294 Grasp(Left, Other):15	Grasp(Left, Ring):12	Touch(Left, Ring):11	 ->Grasp(Left, Other)
1295 Grasp(Left, Other):15	Grasp(Left, Ring):12	Touch(Left, Ring):11	 ->Grasp(Left, Other)
1296 Grasp(Left, Other):15	Grasp(Left, Ring):12	Touch(Left, Ring):11	 ->Grasp(Left, Other)
1297 Grasp(Left, Other):15	Grasp(Left, Ring):12	Touch(Left, Ring):11	 ->Grasp(Left, Other)
1298 Grasp(Left, Other):15	Grasp(Left, Ring):12	Touch(Left, Ring):11	 ->Grasp(Left, Other)
1299 Grasp(Left, Other):15	Grasp(Left, Ring):12	Touch(Left, Ring):11	 ->Grasp(Left, Other)
1300 Grasp(Left, Other):15	Grasp(Left, Ring):12	Touch(Left, Ring):11	 ->Grasp(Left, Other)
1301 Grasp(Left, Other):15	Grasp(Left, Ring):12	Touch(Left, Ring):11	 ->Grasp(Left, Other)
1302 Grasp(Left, Other):15	Grasp(Left, Ring):12	Touch(Left, Ring):11	 ->Grasp(Left, Other)
1303 Grasp(Left, Other):15	Grasp(Left, Ring):12	Touch(Left, Ring):11	 ->Grasp(Left, Other)
1304 Grasp(Left, Other):15	Grasp(Left, Ring):12	Touch(Left, Ring):11	 ->Grasp(Left, Other)
1305 Grasp(Left, Other):15	Grasp(Left, Ring):12	Touch(Left, Ring):11	 ->Grasp(Left, Other)
1306 Grasp(Left, Other):15	Grasp(Left, Ring):12	Touch(Left, Ring):11	 ->Grasp(Left, Other)
1307 Grasp(Left, Other):15	Grasp(Left, Ring):12	Touch(Left, Ring):11	 ->Grasp(Left, Other)
1308 Grasp(Left, Other):15	Grasp(Left, Ring):12	Touch(Left, Ring):11	 ->Grasp(Left, Other)
1309 Grasp(Left, Other):15	Grasp(Left, Ring):12	Touch(Left, Ring):11	 ->Grasp(Left, Other)
1310 Grasp(Left, Other):15	Grasp(Left, Ring):12	Touch(Left, Ring):11	 ->Grasp(Left, Other)
1311 Grasp(Left, Other):15	Grasp(Left, Ring):12	Touch(Left, Ring):11	 ->Grasp(Left, Other)
1312 Grasp(Left, Other):15	Grasp(Left, Ring):12	Touch(Left, Ring):11	 ->Grasp(Left, Other)
1313 Grasp(Left, Other):15	Grasp(Left, Ring):12	Touch(Left, Ring):11	 ->Grasp(Left, Other)
1314 Grasp(Left, Other):15	Grasp(Left, Ring):12	Touch(Left, Ring):11	 ->Grasp(Left, Other)
1315 Grasp(Left, Other):15	Grasp(Left, Ring):12	Touch(Left, Ring):11	 ->Grasp(Left, Other)
1316 Grasp(Left, Other):15	Grasp(Left, Ring):12	Touch(Left, Ring):11	 ->Grasp(Left, Other)
1317 Grasp(Left, Other):15	Grasp(Left, Ring):12	Touch(Left, Ring):11	 ->Grasp(Left, Other)
1318 Grasp(Left, Other):15	Grasp(Left, Ring):12	Touch(Left, Ring):11	 ->Grasp(Left, Other)
1319 Grasp(Left, Other):15	Grasp(Left, Ring):12	Grasp(Left, Ring):12	 ->Grasp(Left, Ring)
1320 Grasp(Left, Other):15	Grasp(Left, Ring):12	Grasp(Left, Ring):12	 ->Grasp(Left, Ring)
1321 Grasp(Left, Other):15	Grasp(Left, Ring):12	Grasp(Left, Ring):12	 ->Grasp(Left, Ring)
1322 Grasp(Left, Other):15	Grasp(Left, Ring):12	Grasp(Left, Ring):12	 ->Grasp(Left, Ring)
1323 Grasp(Left, Other):15	Grasp(Left, Ring):12	Grasp(Left, Ring):12	 ->Grasp(Left, Ring)
1324 Grasp(Left, Other):15	Grasp(Left, Ring):12	Grasp(Left, Ring):12	 ->Grasp(Left, Ring)
1325 Grasp(Left, Other):15	Grasp(Left, Ring):12	Grasp(Left, Ring):12	 ->Grasp(Left, Ring)
1326 Grasp(Left, Other):15	Grasp(Left, Ring):12	Grasp(Left, Ring):12	 ->Grasp(Left, Ring)
1327 Grasp(Left, Other):15	Grasp(Left, Ring):12	Grasp(Left, Ring):12	 ->Grasp(Left, Ring)
1328 Grasp(Left, Other):15	Grasp(Left, Ring):12	Grasp(Left, Ring):12	 ->Grasp(Left, Ring)
1329 Grasp(Left, Other):15	Grasp(Left, Ring):12	Grasp(Left, Ring):12	 ->Grasp(Left, Ring)
1330 Grasp(Left, Other):15	Grasp(Left, Ring):12	Grasp(Left, Ring):12	 ->Grasp(Left, Ring)
1331 Grasp(Left, Other):15	Grasp(Left, Ring):12	Grasp(Left, Ring):12	 ->Grasp(Left, Ring)
1332 Grasp(Left, Other):15	Grasp(Left, Ring):12	Grasp(Left, Ring):12	 ->Grasp(Left, Ring)
1333 Grasp(Left, Other):15	Grasp(Left, Ring):12	Grasp(Left, Ring):12	 ->Grasp(Left, Ring)
1334 Grasp(Left, Other):15	Grasp(Left, Ring):12	Grasp(Left, Ring):12	 ->Grasp(Left, Ring)
1335 Grasp(Left, Other):15	Grasp(Left, Ring):12	Grasp(Left, Ring):12	 ->Grasp(Left, Ring)
1336 Grasp(Left, Other):15	Grasp(Left, Ring):12	Grasp(Left, Ring):12	 ->Grasp(Left, Ring)
1337 Grasp(Left, Other):15	Grasp(Left, Ring):12	Grasp(Left, Ring):12	 ->Grasp(Left, Ring)
1338 Grasp(Left, Other):15	Grasp(Left, Ring):12	Grasp(Left, Ring):12	 ->Grasp(Left, Ring)
1339 Grasp(Left, Other):15	Grasp(Left, Ring):12	Push(Right, Needle):7	 ->Grasp(Left, Other)
1340 Grasp(Left, Other):15	Grasp(Left, Ring):12	Push(Right, Needle):7	 ->Grasp(Left, Other)
1341 Grasp(Left, Other):15	Grasp(Left, Ring):12	Push(Right, Needle):7	 ->Grasp(Left, Other)
1342 Grasp(Left, Other):15	Grasp(Left, Ring):12	Push(Right, Needle):7	 ->Grasp(Left, Other)
1343 Grasp(Left, Other):15	Grasp(Left, Ring):12	Push(Right, Needle):7	 ->Grasp(Left, Other)
1344 Grasp(Left, Other):15	Grasp(Left, Ring):12	Push(Right, Needle):7	 ->Grasp(Left, Other)
1345 Grasp(Left, Other):15	Grasp(Left, Ring):12	Push(Right, Needle):7	 ->Grasp(Left, Other)
1346 Grasp(Left, Other):15	Grasp(Left, Ring):12	Push(Right, Needle):7	 ->Grasp(Left, Other)
1347 Push(Right, Needle):7	Grasp(Left, Ring):12	Push(Right, Needle):7	 ->Push(Right, Needle)
1348 Push(Right, Needle):7	Grasp(Left, Ring):12	Push(Right, Needle):7	 ->Push(Right, Needle)
1349 Push(Right, Needle):7	Grasp(Left, Ring):12	Push(Right, Needle):7	 ->Push(Right, Needle)
1350 Push(Right, Needle):7	Grasp(Left, Ring):12	Push(Right, Needle):7	 ->Push(Right, Needle)
1351 Push(Right, Needle):7	Grasp(Left, Ring):12	Push(Right, Needle):7	 ->Push(Right, Needle)
1352 Push(Right, Needle):7	Grasp(Left, Ring):12	Push(Right, Needle):7	 ->Push(Right, Needle)
1353 Push(Right, Needle):7	Grasp(Left, Ring):12	Push(Right, Needle):7	 ->Push(Right, Needle)
1354 Push(Right, Needle):7	Grasp(Left, Ring):12	Push(Right, Needle):7	 ->Push(Right, Needle)
1355 Push(Right, Needle):7	Grasp(Left, Ring):12	Push(Right, Needle):7	 ->Push(Right, Needle)
1356 Push(Right, Needle):7	Grasp(Left, Ring):12	Push(Right, Needle):7	 ->Push(Right, Needle)
1357 Push(Right, Needle):7	Grasp(Left, Ring):12	Push(Right, Needle):7	 ->Push(Right, Needle)
1358 Push(Right, Needle):7	Grasp(Left, Ring):12	Push(Right, Needle):7	 ->Push(Right, Needle)
1359 Push(Right, Needle):7	Grasp(Left, Ring):12	Push(Right, Needle):7	 ->Push(Right, Needle)
1360 Push(Right, Needle):7	Grasp(Left, Ring):12	Push(Right, Needle):7	 ->Push(Right, Needle)
1361 Push(Right, Needle):7	Grasp(Left, Ring):12	Push(Right, Needle):7	 ->Push(Right, Needle)
1362 Push(Right, Needle):7	Grasp(Left, Ring):12	Push(Right, Needle):7	 ->Push(Right, Needle)
1363 Push(Right, Needle):7	Grasp(Left, Ring):12	Push(Right, Needle):7	 ->Push(Right, Needle)
1364 Push(Right, Needle):7	Grasp(Left, Ring):12	Push(Right, Needle):7	 ->Push(Right, Needle)
1365 Push(Right, Needle):7	Grasp(Left, Ring):12	Push(Right, Needle):7	 ->Push(Right, Needle)
1366 Push(Right, Needle):7	Grasp(Left, Ring):12	Push(Right, Needle):7	 ->Push(Right, Needle)
1367 Push(Right, Needle):7	Grasp(Left, Ring):12	Push(Right, Needle):7	 ->Push(Right, Needle)
1368 Push(Right, Needle):7	Grasp(Left, Ring):12	Push(Right, Needle):7	 ->Push(Right, Needle)
1369 Push(Right, Needle):7	Grasp(Left, Ring):12	Push(Right, Needle):7	 ->Push(Right, Needle)
1370 Push(Right, Needle):7	Grasp(Left, Ring):12	Push(Right, Needle):7	 ->Push(Right, Needle)
1371 Push(Right, Needle):7	Grasp(Left, Ring):12	Push(Right, Needle):7	 ->Push(Right, Needle)
1372 Push(Right, Needle):7	Grasp(Left, Ring):12	Push(Right, Needle):7	 ->Push(Right, Needle)
1373 Push(Right, Needle):7	Grasp(Left, Ring):12	Push(Right, Needle):7	 ->Push(Right, Needle)
1374 Push(Right, Needle):7	Grasp(Left, Ring):12	Push(Right, Needle):7	 ->Push(Right, Needle)
1375 Push(Right, Needle):7	Grasp(Left, Ring):12	Push(Right, Needle):7	 ->Push(Right, Needle)
1376 Push(Right, Needle):7	Grasp(Left, Ring):12	Push(Right, Needle):7	 ->Push(Right, Needle)
1377 Push(Right, Needle):7	Grasp(Left, Ring):12	Push(Right, Needle):7	 ->Push(Right, Needle)
1378 Push(Right, Needle):7	Grasp(Left, Ring):12	Push(Right, Needle):7	 ->Push(Right, Needle)
1379 Push(Right, Needle):7	Grasp(Left, Ring):12	Push(Right, Needle):7	 ->Push(Right, Needle)
1380 Push(Right, Needle):7	Grasp(Left, Ring):12	Push(Right, Needle):7	 ->Push(Right, Needle)
1381 Push(Right, Needle):7	Grasp(Left, Ring):12	Push(Right, Needle):7	 ->Push(Right, Needle)
1382 Push(Right, Needle):7	Grasp(Left, Ring):12	Push(Right, Needle):7	 ->Push(Right, Needle)
1383 Push(Right, Needle):7	Grasp(Left, Ring):12	Push(Right, Needle):7	 ->Push(Right, Needle)
1384 Push(Right, Needle):7	Grasp(Left, Ring):12	Push(Right, Needle):7	 ->Push(Right, Needle)
1385 Push(Right, Needle):7	Grasp(Left, Ring):12	Push(Right, Needle):7	 ->Push(Right, Needle)
1386 Push(Right, Needle):7	Grasp(Left, Ring):12	Push(Right, Needle):7	 ->Push(Right, Needle)
1387 Push(Right, Needle):7	Grasp(Left, Ring):12	Push(Right, Needle):7	 ->Push(Right, Needle)
1388 Push(Right, Needle):7	Grasp(Left, Ring):12	Push(Right, Needle):7	 ->Push(Right, Needle)
1389 Push(Right, Needle):7	Grasp(Left, Ring):12	Push(Right, Needle):7	 ->Push(Right, Needle)
1390 Push(Right, Needle):7	Grasp(Left, Ring):12	Push(Right, Needle):7	 ->Push(Right, Needle)
1391 Push(Right, Needle):7	Grasp(Left, Ring):12	Push(Right, Needle):7	 ->Push(Right, Needle)
1392 Push(Right, Needle):7	Push(Right, Needle):7	Push(Right, Needle):7	 ->Push(Right, Needle)
1393 Push(Right, Needle):7	Push(Right, Needle):7	Push(Right, Needle):7	 ->Push(Right, Needle)
1394 Push(Right, Needle):7	Push(Right, Needle):7	Push(Right, Needle):7	 ->Push(Right, Needle)
1395 Push(Right, Needle):7	Push(Right, Needle):7	Push(Right, Needle):7	 ->Push(Right, Needle)
1396 Push(Right, Needle):7	Push(Right, Needle):7	Push(Right, Needle):7	 ->Push(Right, Needle)
1397 Push(Right, Needle):7	Push(Right, Needle):7	Push(Right, Needle):7	 ->Push(Right, Needle)
1398 Push(Right, Needle):7	Push(Right, Needle):7	Push(Right, Needle):7	 ->Push(Right, Needle)
1399 Push(Right, Needle):7	Push(Right, Needle):7	Push(Right, Needle):7	 ->Push(Right, Needle)
1400 Push(Right, Needle):7	Push(Right, Needle):7	Push(Right, Needle):7	 ->Push(Right, Needle)
1401 Push(Right, Needle):7	Push(Right, Needle):7	Push(Right, Needle):7	 ->Push(Right, Needle)
1402 Push(Right, Needle):7	Push(Right, Needle):7	Push(Right, Needle):7	 ->Push(Right, Needle)
1403 Push(Right, Needle):7	Push(Right, Needle):7	Push(Right, Needle):7	 ->Push(Right, Needle)
1404 Push(Right, Needle):7	Push(Right, Needle):7	Push(Right, Needle):7	 ->Push(Right, Needle)
1405 Push(Right, Needle):7	Push(Right, Needle):7	Push(Right, Needle):7	 ->Push(Right, Needle)
1406 Push(Right, Needle):7	Push(Right, Needle):7	Push(Right, Needle):7	 ->Push(Right, Needle)
1407 Push(Right, Needle):7	Push(Right, Needle):7	Push(Right, Needle):7	 ->Push(Right, Needle)
1408 Push(Right, Needle):7	Push(Right, Needle):7	Push(Right, Needle):7	 ->Push(Right, Needle)
1409 Push(Right, Needle):7	Push(Right, Needle):7	Push(Right, Needle):7	 ->Push(Right, Needle)
1410 Push(Right, Needle):7	Push(Right, Needle):7	Push(Right, Needle):7	 ->Push(Right, Needle)
1411 Push(Right, Needle):7	Push(Right, Needle):7	Push(Right, Needle):7	 ->Push(Right, Needle)
1412 Push(Right, Needle):7	Push(Right, Needle):7	Push(Right, Needle):7	 ->Push(Right, Needle)
1413 Push(Right, Needle):7	Push(Right, Needle):7	Push(Right, Needle):7	 ->Push(Right, Needle)
1414 Push(Right, Needle):7	Push(Right, Needle):7	Push(Right, Needle):7	 ->Push(Right, Needle)
1415 Push(Right, Needle):7	Push(Right, Needle):7	Push(Right, Needle):7	 ->Push(Right, Needle)
1416 Push(Right, Needle):7	Push(Right, Needle):7	Push(Right, Needle):7	 ->Push(Right, Needle)
1417 Push(Right, Needle):7	Push(Right, Needle):7	Push(Right, Needle):7	 ->Push(Right, Needle)
1418 Push(Right, Needle):7	Push(Right, Needle):7	Push(Right, Needle):7	 ->Push(Right, Needle)
1419 Push(Right, Needle):7	Push(Right, Needle):7	Push(Right, Needle):7	 ->Push(Right, Needle)
1420 Push(Right, Needle):7	Push(Right, Needle):7	Push(Right, Needle):7	 ->Push(Right, Needle)
1421 Push(Right, Needle):7	Push(Right, Needle):7	Push(Right, Needle):7	 ->Push(Right, Needle)
1422 Push(Right, Needle):7	Push(Right, Needle):7	Push(Right, Needle):7	 ->Push(Right, Needle)
1423 Push(Right, Needle):7	Push(Right, Needle):7	Push(Right, Needle):7	 ->Push(Right, Needle)
1424 Push(Right, Needle):7	Push(Right, Needle):7	Push(Right, Needle):7	 ->Push(Right, Needle)
1425 Push(Right, Needle):7	Push(Right, Needle):7	Push(Right, Needle):7	 ->Push(Right, Needle)
1426 Push(Right, Needle):7	Push(Right, Needle):7	Push(Right, Needle):7	 ->Push(Right, Needle)
1427 Push(Right, Needle):7	Push(Right, Needle):7	Push(Right, Needle):7	 ->Push(Right, Needle)
1428 Push(Right, Needle):7	Push(Right, Needle):7	Push(Right, Needle):7	 ->Push(Right, Needle)
1429 Push(Right, Needle):7	Push(Right, Needle):7	Push(Right, Needle):7	 ->Push(Right, Needle)
1430 Push(Right, Needle):7	Push(Right, Needle):7	Push(Right, Needle):7	 ->Push(Right, Needle)
1431 Push(Right, Needle):7	Push(Right, Needle):7	Push(Right, Needle):7	 ->Push(Right, Needle)
1432 Push(Right, Needle):7	Push(Right, Needle):7	Push(Right, Needle):7	 ->Push(Right, Needle)
1433 Push(Right, Needle):7	Push(Right, Needle):7	Push(Right, Needle):7	 ->Push(Right, Needle)
1434 Push(Right, Needle):7	Push(Right, Needle):7	Push(Right, Needle):7	 ->Push(Right, Needle)
1435 Push(Right, Needle):7	Push(Right, Needle):7	Push(Right, Needle):7	 ->Push(Right, Needle)
1436 Push(Right, Needle):7	Push(Right, Needle):7	Push(Right, Needle):7	 ->Push(Right, Needle)
1437 Push(Right, Needle):7	Push(Right, Needle):7	Push(Right, Needle):7	 ->Push(Right, Needle)
1438 Push(Right, Needle):7	Push(Right, Needle):7	Push(Right, Needle):7	 ->Push(Right, Needle)
1439 Push(Right, Needle):7	Push(Right, Needle):7	Push(Right, Needle):7	 ->Push(Right, Needle)
1440 Push(Right, Needle):7	Push(Right, Needle):7	Push(Right, Needle):7	 ->Push(Right, Needle)
1441 Push(Right, Needle):7	Push(Right, Needle):7	Push(Right, Needle):7	 ->Push(Right, Needle)
1442 Push(Right, Needle):7	Push(Right, Needle):7	Push(Right, Needle):7	 ->Push(Right, Needle)
1443 Push(Right, Needle):7	Push(Right, Needle):7	Push(Right, Needle):7	 ->Push(Right, Needle)
1444 Push(Right, Needle):7	Push(Right, Needle):7	Push(Right, Needle):7	 ->Push(Right, Needle)
1445 Push(Right, Needle):7	Push(Right, Needle):7	Push(Right, Needle):7	 ->Push(Right, Needle)
1446 Push(Right, Needle):7	Push(Right, Needle):7	Release(Left, Ring):14	 ->Push(Right, Needle)
1447 Push(Right, Needle):7	Push(Right, Needle):7	Release(Left, Ring):14	 ->Push(Right, Needle)
1448 Push(Right, Needle):7	Push(Right, Needle):7	Release(Left, Ring):14	 ->Push(Right, Needle)
1449 Push(Right, Needle):7	Push(Right, Needle):7	Release(Left, Ring):14	 ->Push(Right, Needle)
1450 Push(Right, Needle):7	Push(Right, Needle):7	Release(Left, Ring):14	 ->Push(Right, Needle)
1451 Push(Right, Needle):7	Push(Right, Needle):7	Release(Left, Ring):14	 ->Push(Right, Needle)
1452 Push(Right, Needle):7	Push(Right, Needle):7	Release(Left, Ring):14	 ->Push(Right, Needle)
1453 Push(Right, Needle):7	Push(Right, Needle):7	Release(Left, Ring):14	 ->Push(Right, Needle)
1454 Push(Right, Needle):7	Push(Right, Needle):7	Release(Left, Ring):14	 ->Push(Right, Needle)
1455 Push(Right, Needle):7	Push(Right, Needle):7	Release(Left, Ring):14	 ->Push(Right, Needle)
1456 Push(Right, Needle):7	Push(Right, Needle):7	Release(Left, Ring):14	 ->Push(Right, Needle)
1457 Push(Right, Needle):7	Push(Right, Needle):7	Release(Left, Ring):14	 ->Push(Right, Needle)
1458 Push(Right, Needle):7	Push(Right, Needle):7	Release(Left, Ring):14	 ->Push(Right, Needle)
1459 Push(Right, Needle):7	Push(Right, Needle):7	Release(Left, Ring):14	 ->Push(Right, Needle)
1460 Push(Right, Needle):7	Push(Right, Needle):7	Release(Left, Ring):14	 ->Push(Right, Needle)
1461 Push(Right, Needle):7	Push(Right, Needle):7	Release(Left, Ring):14	 ->Push(Right, Needle)
1462 Push(Right, Needle):7	Push(Right, Needle):7	Release(Left, Ring):14	 ->Push(Right, Needle)
1463 Push(Right, Needle):7	Push(Right, Needle):7	Release(Left, Ring):14	 ->Push(Right, Needle)
1464 Push(Right, Needle):7	Push(Right, Needle):7	Release(Left, Ring):14	 ->Push(Right, Needle)
1465 Push(Right, Needle):7	Push(Right, Needle):7	Touch(Left, Needle):4	 ->Push(Right, Needle)
1466 Push(Right, Needle):7	Push(Right, Needle):7	Touch(Left, Needle):4	 ->Push(Right, Needle)
1467 Push(Right, Needle):7	Push(Right, Needle):7	Touch(Left, Needle):4	 ->Push(Right, Needle)
1468 Push(Right, Needle):7	Push(Right, Needle):7	Touch(Left, Needle):4	 ->Push(Right, Needle)
1469 Push(Right, Needle):7	Push(Right, Needle):7	Touch(Left, Needle):4	 ->Push(Right, Needle)
1470 Push(Right, Needle):7	Push(Right, Needle):7	Touch(Left, Needle):4	 ->Push(Right, Needle)
1471 Push(Right, Needle):7	Release(Left, Ring):14	Touch(Left, Needle):4	 ->Push(Right, Needle)
1472 Push(Right, Needle):7	Release(Left, Ring):14	Touch(Left, Needle):4	 ->Push(Right, Needle)
1473 Push(Right, Needle):7	Release(Left, Ring):14	Touch(Left, Needle):4	 ->Push(Right, Needle)
1474 Push(Right, Needle):7	Release(Left, Ring):14	Touch(Left, Needle):4	 ->Push(Right, Needle)
1475 Grasp(Left, Needle):5	Release(Left, Ring):14	Touch(Left, Needle):4	 ->Grasp(Left, Needle)
1476 Grasp(Left, Needle):5	Release(Left, Ring):14	Touch(Left, Needle):4	 ->Grasp(Left, Needle)
1477 Grasp(Left, Needle):5	Release(Left, Ring):14	Touch(Left, Needle):4	 ->Grasp(Left, Needle)
1478 Grasp(Left, Needle):5	Release(Left, Ring):14	Touch(Left, Needle):4	 ->Grasp(Left, Needle)
1479 Grasp(Left, Needle):5	Release(Left, Ring):14	Touch(Left, Needle):4	 ->Grasp(Left, Needle)
1480 Grasp(Left, Needle):5	Release(Left, Ring):14	Touch(Left, Needle):4	 ->Grasp(Left, Needle)
1481 Grasp(Left, Needle):5	Release(Left, Ring):14	Touch(Left, Needle):4	 ->Grasp(Left, Needle)
1482 Grasp(Left, Needle):5	Release(Left, Ring):14	Touch(Left, Needle):4	 ->Grasp(Left, Needle)
1483 Grasp(Left, Needle):5	Release(Left, Ring):14	Touch(Left, Needle):4	 ->Grasp(Left, Needle)
1484 Grasp(Left, Needle):5	Release(Left, Ring):14	Touch(Left, Needle):4	 ->Grasp(Left, Needle)
1485 Grasp(Left, Needle):5	Release(Left, Ring):14	Touch(Left, Needle):4	 ->Grasp(Left, Needle)
1486 Grasp(Left, Needle):5	Release(Left, Ring):14	Touch(Left, Needle):4	 ->Grasp(Left, Needle)
1487 Grasp(Left, Needle):5	Release(Left, Ring):14	Touch(Left, Needle):4	 ->Grasp(Left, Needle)
1488 Grasp(Left, Needle):5	Release(Left, Ring):14	Touch(Left, Needle):4	 ->Grasp(Left, Needle)
1489 Grasp(Left, Needle):5	Release(Left, Ring):14	Touch(Left, Needle):4	 ->Grasp(Left, Needle)
1490 Grasp(Left, Needle):5	Release(Left, Ring):14	Touch(Left, Needle):4	 ->Grasp(Left, Needle)
1491 Grasp(Left, Needle):5	Release(Left, Ring):14	Touch(Left, Needle):4	 ->Grasp(Left, Needle)
1492 Grasp(Left, Needle):5	Release(Left, Ring):14	Touch(Left, Needle):4	 ->Grasp(Left, Needle)
1493 Grasp(Left, Needle):5	Release(Left, Ring):14	Touch(Left, Needle):4	 ->Grasp(Left, Needle)
1494 Grasp(Left, Needle):5	Release(Left, Ring):14	Touch(Left, Needle):4	 ->Grasp(Left, Needle)
1495 Grasp(Left, Needle):5	Release(Left, Ring):14	Touch(Left, Needle):4	 ->Grasp(Left, Needle)
1496 Grasp(Left, Needle):5	Release(Left, Ring):14	Touch(Left, Needle):4	 ->Grasp(Left, Needle)
1497 Grasp(Left, Needle):5	Release(Left, Ring):14	Touch(Left, Needle):4	 ->Grasp(Left, Needle)
1498 Grasp(Left, Needle):5	Release(Left, Ring):14	Touch(Left, Needle):4	 ->Grasp(Left, Needle)
1499 Grasp(Left, Needle):5	Release(Left, Ring):14	Touch(Left, Needle):4	 ->Grasp(Left, Needle)
1500 Grasp(Left, Needle):5	Release(Left, Ring):14	Touch(Left, Needle):4	 ->Grasp(Left, Needle)
1501 Grasp(Left, Needle):5	Release(Left, Ring):14	Touch(Left, Needle):4	 ->Grasp(Left, Needle)
1502 Grasp(Left, Needle):5	Release(Left, Ring):14	Touch(Left, Needle):4	 ->Grasp(Left, Needle)
1503 Grasp(Left, Needle):5	Release(Left, Ring):14	Touch(Left, Needle):4	 ->Grasp(Left, Needle)
1504 Grasp(Left, Needle):5	Release(Left, Ring):14	Touch(Left, Needle):4	 ->Grasp(Left, Needle)
1505 Grasp(Left, Needle):5	Release(Left, Ring):14	Touch(Left, Needle):4	 ->Grasp(Left, Needle)
1506 Grasp(Left, Needle):5	Release(Left, Ring):14	Touch(Left, Needle):4	 ->Grasp(Left, Needle)
1507 Grasp(Left, Needle):5	Release(Left, Ring):14	Touch(Left, Needle):4	 ->Grasp(Left, Needle)
1508 Grasp(Left, Needle):5	Release(Left, Ring):14	Touch(Left, Needle):4	 ->Grasp(Left, Needle)
1509 Grasp(Left, Needle):5	Release(Left, Ring):14	Touch(Left, Needle):4	 ->Grasp(Left, Needle)
1510 Grasp(Left, Needle):5	Release(Left, Ring):14	Touch(Left, Needle):4	 ->Grasp(Left, Needle)
1511 Grasp(Left, Needle):5	Release(Left, Ring):14	Touch(Left, Needle):4	 ->Grasp(Left, Needle)
1512 Grasp(Left, Needle):5	Release(Left, Ring):14	Touch(Left, Needle):4	 ->Grasp(Left, Needle)
1513 Grasp(Left, Needle):5	Release(Left, Ring):14	Touch(Left, Needle):4	 ->Grasp(Left, Needle)
1514 Grasp(Left, Needle):5	Release(Left, Ring):14	Touch(Left, Needle):4	 ->Grasp(Left, Needle)
1515 Grasp(Left, Needle):5	Release(Left, Ring):14	Touch(Left, Needle):4	 ->Grasp(Left, Needle)
1516 Grasp(Left, Needle):5	Release(Left, Ring):14	Touch(Left, Needle):4	 ->Grasp(Left, Needle)
1517 Grasp(Left, Needle):5	Release(Left, Ring):14	Touch(Left, Needle):4	 ->Grasp(Left, Needle)
1518 Grasp(Left, Needle):5	Release(Left, Ring):14	Touch(Left, Needle):4	 ->Grasp(Left, Needle)
1519 Grasp(Left, Needle):5	Release(Left, Ring):14	Touch(Left, Needle):4	 ->Grasp(Left, Needle)
1520 Grasp(Left, Needle):5	Release(Left, Ring):14	Touch(Left, Needle):4	 ->Grasp(Left, Needle)
1521 Grasp(Left, Needle):5	Release(Left, Ring):14	Touch(Left, Needle):4	 ->Grasp(Left, Needle)
1522 Grasp(Left, Needle):5	Release(Left, Ring):14	Touch(Left, Needle):4	 ->Grasp(Left, Needle)
1523 Grasp(Left, Needle):5	Release(Left, Ring):14	Grasp(Left, Needle):5	 ->Grasp(Left, Needle)
1524 Grasp(Left, Needle):5	Release(Left, Ring):14	Grasp(Left, Needle):5	 ->Grasp(Left, Needle)
1525 Grasp(Left, Needle):5	Release(Left, Ring):14	Grasp(Left, Needle):5	 ->Grasp(Left, Needle)
1526 Grasp(Left, Needle):5	Release(Left, Ring):14	Grasp(Left, Needle):5	 ->Grasp(Left, Needle)
1527 Grasp(Left, Needle):5	Release(Left, Ring):14	Grasp(Left, Needle):5	 ->Grasp(Left, Needle)
1528 Grasp(Left, Needle):5	Release(Left, Ring):14	Grasp(Left, Needle):5	 ->Grasp(Left, Needle)
1529 Grasp(Left, Needle):5	Release(Left, Ring):14	Grasp(Left, Needle):5	 ->Grasp(Left, Needle)
1530 Grasp(Left, Needle):5	Release(Left, Ring):14	Grasp(Left, Needle):5	 ->Grasp(Left, Needle)
1531 Grasp(Left, Needle):5	Release(Left, Ring):14	Grasp(Left, Needle):5	 ->Grasp(Left, Needle)
1532 Grasp(Left, Needle):5	Release(Left, Ring):14	Release(Right, Needle):2	 ->Grasp(Left, Needle)
1533 Grasp(Left, Needle):5	Release(Left, Ring):14	Release(Right, Needle):2	 ->Grasp(Left, Needle)
1534 Grasp(Left, Needle):5	Release(Left, Ring):14	Release(Right, Needle):2	 ->Grasp(Left, Needle)
1535 Grasp(Left, Needle):5	Grasp(Left, Needle):5	Release(Right, Needle):2	 ->Grasp(Left, Needle)
1536 Grasp(Left, Needle):5	Grasp(Left, Needle):5	Release(Right, Needle):2	 ->Grasp(Left, Needle)
1537 Grasp(Left, Needle):5	Grasp(Left, Needle):5	Release(Right, Needle):2	 ->Grasp(Left, Needle)
1538 Grasp(Left, Needle):5	Grasp(Left, Needle):5	Release(Right, Needle):2	 ->Grasp(Left, Needle)
1539 Grasp(Left, Needle):5	Grasp(Left, Needle):5	Release(Right, Needle):2	 ->Grasp(Left, Needle)
1540 Grasp(Left, Needle):5	Grasp(Left, Needle):5	Pull(Left, Needle):9	 ->Grasp(Left, Needle)
1541 Grasp(Left, Needle):5	Grasp(Left, Needle):5	Pull(Left, Needle):9	 ->Grasp(Left, Needle)
1542 Pull(Left, Needle):9	Release(Right, Needle):2	Pull(Left, Needle):9	 ->Pull(Left, Needle)
1543 Pull(Left, Needle):9	Release(Right, Needle):2	Pull(Left, Needle):9	 ->Pull(Left, Needle)
1544 Pull(Left, Needle):9	Release(Right, Needle):2	Pull(Left, Needle):9	 ->Pull(Left, Needle)
1545 Pull(Left, Needle):9	Release(Right, Needle):2	Pull(Left, Needle):9	 ->Pull(Left, Needle)
1546 Pull(Left, Needle):9	Release(Right, Needle):2	Pull(Left, Needle):9	 ->Pull(Left, Needle)
1547 Pull(Left, Needle):9	Release(Right, Needle):2	Pull(Left, Needle):9	 ->Pull(Left, Needle)
1548 Pull(Left, Needle):9	Release(Right, Needle):2	Pull(Left, Needle):9	 ->Pull(Left, Needle)
1549 Pull(Left, Needle):9	Release(Right, Needle):2	Pull(Left, Needle):9	 ->Pull(Left, Needle)
1550 Pull(Left, Needle):9	Release(Right, Needle):2	Pull(Left, Needle):9	 ->Pull(Left, Needle)
1551 Pull(Left, Needle):9	Release(Right, Needle):2	Pull(Left, Needle):9	 ->Pull(Left, Needle)
1552 Pull(Left, Needle):9	Release(Right, Needle):2	Pull(Left, Needle):9	 ->Pull(Left, Needle)
1553 Pull(Left, Needle):9	Release(Right, Needle):2	Pull(Left, Needle):9	 ->Pull(Left, Needle)
1554 Pull(Left, Needle):9	Pull(Left, Needle):9	Pull(Left, Needle):9	 ->Pull(Left, Needle)
1555 Pull(Left, Needle):9	Pull(Left, Needle):9	Pull(Left, Needle):9	 ->Pull(Left, Needle)
1556 Pull(Left, Needle):9	Pull(Left, Needle):9	Pull(Left, Needle):9	 ->Pull(Left, Needle)
1557 Pull(Left, Needle):9	Pull(Left, Needle):9	Pull(Left, Needle):9	 ->Pull(Left, Needle)
1558 Pull(Left, Needle):9	Pull(Left, Needle):9	Pull(Left, Needle):9	 ->Pull(Left, Needle)
1559 Pull(Left, Needle):9	Pull(Left, Needle):9	Pull(Left, Needle):9	 ->Pull(Left, Needle)
1560 Pull(Left, Needle):9	Pull(Left, Needle):9	Pull(Left, Needle):9	 ->Pull(Left, Needle)
1561 Pull(Left, Needle):9	Pull(Left, Needle):9	Pull(Left, Needle):9	 ->Pull(Left, Needle)
1562 Pull(Left, Needle):9	Pull(Left, Needle):9	Pull(Left, Needle):9	 ->Pull(Left, Needle)
1563 Pull(Left, Needle):9	Pull(Left, Needle):9	Pull(Left, Needle):9	 ->Pull(Left, Needle)
1564 Pull(Left, Needle):9	Pull(Left, Needle):9	Pull(Left, Needle):9	 ->Pull(Left, Needle)
1565 Pull(Left, Needle):9	Pull(Left, Needle):9	Pull(Left, Needle):9	 ->Pull(Left, Needle)
1566 Pull(Left, Needle):9	Pull(Left, Needle):9	Pull(Left, Needle):9	 ->Pull(Left, Needle)
1567 Pull(Left, Needle):9	Pull(Left, Needle):9	Pull(Left, Needle):9	 ->Pull(Left, Needle)
1568 Pull(Left, Needle):9	Pull(Left, Needle):9	Pull(Left, Needle):9	 ->Pull(Left, Needle)
1569 Pull(Left, Needle):9	Pull(Left, Needle):9	Pull(Left, Needle):9	 ->Pull(Left, Needle)
1570 Pull(Left, Needle):9	Pull(Left, Needle):9	Pull(Left, Needle):9	 ->Pull(Left, Needle)
1571 Pull(Left, Needle):9	Pull(Left, Needle):9	Pull(Left, Needle):9	 ->Pull(Left, Needle)
1572 Pull(Left, Needle):9	Pull(Left, Needle):9	Touch(Right, Needle):1	 ->Pull(Left, Needle)
1573 Pull(Left, Needle):9	Pull(Left, Needle):9	Touch(Right, Needle):1	 ->Pull(Left, Needle)
1574 Pull(Left, Needle):9	Pull(Left, Needle):9	Touch(Right, Needle):1	 ->Pull(Left, Needle)
1575 Pull(Left, Needle):9	Pull(Left, Needle):9	Touch(Right, Needle):1	 ->Pull(Left, Needle)
1576 Pull(Left, Needle):9	Pull(Left, Needle):9	Touch(Right, Needle):1	 ->Pull(Left, Needle)
1577 Pull(Left, Needle):9	Pull(Left, Needle):9	Touch(Right, Needle):1	 ->Pull(Left, Needle)
1578 Pull(Left, Needle):9	Pull(Left, Needle):9	Touch(Right, Needle):1	 ->Pull(Left, Needle)
1579 Pull(Left, Needle):9	Pull(Left, Needle):9	Touch(Right, Needle):1	 ->Pull(Left, Needle)
1580 Pull(Left, Needle):9	Pull(Left, Needle):9	Touch(Right, Needle):1	 ->Pull(Left, Needle)
1581 Pull(Left, Needle):9	Pull(Left, Needle):9	Touch(Right, Needle):1	 ->Pull(Left, Needle)
1582 Pull(Left, Needle):9	Pull(Left, Needle):9	Touch(Right, Needle):1	 ->Pull(Left, Needle)
1583 Pull(Left, Needle):9	Pull(Left, Needle):9	Touch(Right, Needle):1	 ->Pull(Left, Needle)
1584 Pull(Left, Needle):9	Pull(Left, Needle):9	Touch(Right, Needle):1	 ->Pull(Left, Needle)
1585 Pull(Left, Needle):9	Pull(Left, Needle):9	Touch(Right, Needle):1	 ->Pull(Left, Needle)
1586 Pull(Left, Needle):9	Pull(Left, Needle):9	Touch(Right, Needle):1	 ->Pull(Left, Needle)
1587 Pull(Left, Needle):9	Pull(Left, Needle):9	Touch(Right, Needle):1	 ->Pull(Left, Needle)
1588 Pull(Left, Needle):9	Pull(Left, Needle):9	Touch(Right, Needle):1	 ->Pull(Left, Needle)
1589 Pull(Left, Needle):9	Pull(Left, Needle):9	Touch(Right, Needle):1	 ->Pull(Left, Needle)
1590 Pull(Left, Needle):9	Pull(Left, Needle):9	Touch(Right, Needle):1	 ->Pull(Left, Needle)
1591 Pull(Left, Needle):9	Pull(Left, Needle):9	Touch(Right, Needle):1	 ->Pull(Left, Needle)
1592 Pull(Left, Needle):9	Pull(Left, Needle):9	Touch(Right, Needle):1	 ->Pull(Left, Needle)
1593 Pull(Left, Needle):9	Pull(Left, Needle):9	Touch(Right, Needle):1	 ->Pull(Left, Needle)
1594 Pull(Left, Needle):9	Pull(Left, Needle):9	Touch(Right, Needle):1	 ->Pull(Left, Needle)
1595 Grasp(Right, Needle):0	Pull(Left, Needle):9	Touch(Right, Needle):1	 ->Grasp(Right, Needle)
1596 Grasp(Right, Needle):0	Pull(Left, Needle):9	Touch(Right, Needle):1	 ->Grasp(Right, Needle)
1597 Grasp(Right, Needle):0	Pull(Left, Needle):9	Touch(Right, Needle):1	 ->Grasp(Right, Needle)
1598 Grasp(Right, Needle):0	Pull(Left, Needle):9	Touch(Right, Needle):1	 ->Grasp(Right, Needle)
1599 Grasp(Right, Needle):0	Pull(Left, Needle):9	Touch(Right, Needle):1	 ->Grasp(Right, Needle)
1600 Grasp(Right, Needle):0	Pull(Left, Needle):9	Touch(Right, Needle):1	 ->Grasp(Right, Needle)
1601 Grasp(Right, Needle):0	Pull(Left, Needle):9	Touch(Right, Needle):1	 ->Grasp(Right, Needle)
1602 Grasp(Right, Needle):0	Pull(Left, Needle):9	Touch(Right, Needle):1	 ->Grasp(Right, Needle)
1603 Grasp(Right, Needle):0	Pull(Left, Needle):9	Touch(Right, Needle):1	 ->Grasp(Right, Needle)
1604 Grasp(Right, Needle):0	Pull(Left, Needle):9	Touch(Right, Needle):1	 ->Grasp(Right, Needle)
1605 Grasp(Right, Needle):0	Pull(Left, Needle):9	Touch(Right, Needle):1	 ->Grasp(Right, Needle)
1606 Grasp(Right, Needle):0	Pull(Left, Needle):9	Grasp(Right, Needle):0	 ->Grasp(Right, Needle)
1607 Grasp(Right, Needle):0	Pull(Left, Needle):9	Grasp(Right, Needle):0	 ->Grasp(Right, Needle)
1608 Grasp(Right, Needle):0	Pull(Left, Needle):9	Grasp(Right, Needle):0	 ->Grasp(Right, Needle)
1609 Grasp(Right, Needle):0	Pull(Left, Needle):9	Grasp(Right, Needle):0	 ->Grasp(Right, Needle)
1610 Grasp(Right, Needle):0	Pull(Left, Needle):9	Grasp(Right, Needle):0	 ->Grasp(Right, Needle)
1611 Grasp(Right, Needle):0	Pull(Left, Needle):9	Grasp(Right, Needle):0	 ->Grasp(Right, Needle)
1612 Grasp(Right, Needle):0	Pull(Left, Needle):9	Grasp(Right, Needle):0	 ->Grasp(Right, Needle)
1613 Grasp(Right, Needle):0	Pull(Left, Needle):9	Grasp(Right, Needle):0	 ->Grasp(Right, Needle)
1614 Grasp(Right, Needle):0	Pull(Left, Needle):9	Grasp(Right, Needle):0	 ->Grasp(Right, Needle)
1615 Grasp(Right, Needle):0	Pull(Left, Needle):9	Grasp(Right, Needle):0	 ->Grasp(Right, Needle)
1616 Grasp(Right, Needle):0	Pull(Left, Needle):9	Grasp(Right, Needle):0	 ->Grasp(Right, Needle)
1617 Grasp(Right, Needle):0	Grasp(Right, Needle):0	Release(Left, Needle):6	 ->Grasp(Right, Needle)
1618 Grasp(Right, Needle):0	Grasp(Right, Needle):0	Release(Left, Needle):6	 ->Grasp(Right, Needle)
1619 Grasp(Right, Needle):0	Grasp(Right, Needle):0	Release(Left, Needle):6	 ->Grasp(Right, Needle)
1620 Grasp(Right, Needle):0	Grasp(Right, Needle):0	Release(Left, Needle):6	 ->Grasp(Right, Needle)
1621 Grasp(Right, Needle):0	Grasp(Right, Needle):0	Release(Left, Needle):6	 ->Grasp(Right, Needle)
1622 Grasp(Right, Needle):0	Grasp(Right, Needle):0	Release(Left, Needle):6	 ->Grasp(Right, Needle)
1623 Grasp(Right, Needle):0	Grasp(Right, Needle):0	Release(Left, Needle):6	 ->Grasp(Right, Needle)
1624 Grasp(Right, Needle):0	Grasp(Right, Needle):0	Release(Left, Needle):6	 ->Grasp(Right, Needle)
1625 Grasp(Right, Needle):0	Grasp(Right, Needle):0	Release(Left, Needle):6	 ->Grasp(Right, Needle)
1626 Grasp(Right, Needle):0	Grasp(Right, Needle):0	Release(Left, Needle):6	 ->Grasp(Right, Needle)
1627 Grasp(Right, Needle):0	Grasp(Right, Needle):0	Release(Left, Needle):6	 ->Grasp(Right, Needle)
1628 Grasp(Right, Needle):0	Release(Left, Needle):6	Untouch(Left, Needle):8	 ->Grasp(Right, Needle)
1629 Grasp(Right, Needle):0	Release(Left, Needle):6	Untouch(Left, Needle):8	 ->Grasp(Right, Needle)
1630 Grasp(Right, Needle):0	Release(Left, Needle):6	Untouch(Left, Needle):8	 ->Grasp(Right, Needle)
1631 Grasp(Right, Needle):0	Release(Left, Needle):6	Untouch(Left, Needle):8	 ->Grasp(Right, Needle)
1632 Grasp(Right, Needle):0	Release(Left, Needle):6	Untouch(Left, Needle):8	 ->Grasp(Right, Needle)
1633 Grasp(Right, Needle):0	Release(Left, Needle):6	Untouch(Left, Needle):8	 ->Grasp(Right, Needle)
1634 Grasp(Right, Needle):0	Release(Left, Needle):6	Untouch(Left, Needle):8	 ->Grasp(Right, Needle)
1635 Grasp(Right, Needle):0	Release(Left, Needle):6	Untouch(Left, Needle):8	 ->Grasp(Right, Needle)
1636 Grasp(Right, Needle):0	Release(Left, Needle):6	Untouch(Left, Needle):8	 ->Grasp(Right, Needle)
1637 Grasp(Right, Needle):0	Release(Left, Needle):6	Untouch(Left, Needle):8	 ->Grasp(Right, Needle)
1638 Grasp(Right, Needle):0	Release(Left, Needle):6	Untouch(Left, Needle):8	 ->Grasp(Right, Needle)
1639 Grasp(Right, Needle):0	Release(Left, Needle):6	Untouch(Left, Needle):8	 ->Grasp(Right, Needle)
1640 Grasp(Right, Needle):0	Release(Left, Needle):6	Untouch(Left, Needle):8	 ->Grasp(Right, Needle)
1641 Grasp(Right, Needle):0	Release(Left, Needle):6	Untouch(Left, Needle):8	 ->Grasp(Right, Needle)
1642 Grasp(Right, Needle):0	Release(Left, Needle):6	Untouch(Left, Needle):8	 ->Grasp(Right, Needle)
1643 Grasp(Right, Needle):0	Release(Left, Needle):6	Untouch(Left, Needle):8	 ->Grasp(Right, Needle)
1644 Push(Right, Needle):7	Release(Left, Needle):6	Untouch(Left, Needle):8	 ->Push(Right, Needle)
1645 Push(Right, Needle):7	Release(Left, Needle):6	Untouch(Left, Needle):8	 ->Push(Right, Needle)
1646 Push(Right, Needle):7	Release(Left, Needle):6	Untouch(Left, Needle):8	 ->Push(Right, Needle)
1647 Push(Right, Needle):7	Release(Left, Needle):6	Untouch(Left, Needle):8	 ->Push(Right, Needle)
1648 Push(Right, Needle):7	Release(Left, Needle):6	Push(Right, Needle):7	 ->Push(Right, Needle)
1649 Push(Right, Needle):7	Release(Left, Needle):6	Push(Right, Needle):7	 ->Push(Right, Needle)
1650 Push(Right, Needle):7	Release(Left, Needle):6	Push(Right, Needle):7	 ->Push(Right, Needle)
1651 Push(Right, Needle):7	Release(Left, Needle):6	Push(Right, Needle):7	 ->Push(Right, Needle)
1652 Push(Right, Needle):7	Release(Left, Needle):6	Push(Right, Needle):7	 ->Push(Right, Needle)
1653 Push(Right, Needle):7	Release(Left, Needle):6	Push(Right, Needle):7	 ->Push(Right, Needle)
1654 Push(Right, Needle):7	Release(Left, Needle):6	Push(Right, Needle):7	 ->Push(Right, Needle)
1655 Push(Right, Needle):7	Release(Left, Needle):6	Push(Right, Needle):7	 ->Push(Right, Needle)
1656 Push(Right, Needle):7	Release(Left, Needle):6	Push(Right, Needle):7	 ->Push(Right, Needle)
1657 Push(Right, Needle):7	Release(Left, Needle):6	Push(Right, Needle):7	 ->Push(Right, Needle)
1658 Push(Right, Needle):7	Release(Left, Needle):6	Push(Right, Needle):7	 ->Push(Right, Needle)
1659 Push(Right, Needle):7	Release(Left, Needle):6	Push(Right, Needle):7	 ->Push(Right, Needle)
1660 Push(Right, Needle):7	Release(Left, Needle):6	Push(Right, Needle):7	 ->Push(Right, Needle)
1661 Push(Right, Needle):7	Release(Left, Needle):6	Push(Right, Needle):7	 ->Push(Right, Needle)
1662 Push(Right, Needle):7	Release(Left, Needle):6	Push(Right, Needle):7	 ->Push(Right, Needle)
1663 Push(Right, Needle):7	Release(Left, Needle):6	Push(Right, Needle):7	 ->Push(Right, Needle)
1664 Push(Right, Needle):7	Release(Left, Needle):6	Push(Right, Needle):7	 ->Push(Right, Needle)
1665 Push(Right, Needle):7	Release(Left, Needle):6	Push(Right, Needle):7	 ->Push(Right, Needle)
1666 Push(Right, Needle):7	Release(Left, Needle):6	Push(Right, Needle):7	 ->Push(Right, Needle)
1667 Push(Right, Needle):7	Release(Left, Needle):6	Push(Right, Needle):7	 ->Push(Right, Needle)
1668 Push(Right, Needle):7	Release(Left, Needle):6	Push(Right, Needle):7	 ->Push(Right, Needle)
1669 Push(Right, Needle):7	Release(Left, Needle):6	Push(Right, Needle):7	 ->Push(Right, Needle)
1670 Push(Right, Needle):7	Release(Left, Needle):6	Push(Right, Needle):7	 ->Push(Right, Needle)
1671 Push(Right, Needle):7	Release(Left, Needle):6	Push(Right, Needle):7	 ->Push(Right, Needle)
1672 Push(Right, Needle):7	Release(Left, Needle):6	Push(Right, Needle):7	 ->Push(Right, Needle)
1673 Push(Right, Needle):7	Release(Left, Needle):6	Push(Right, Needle):7	 ->Push(Right, Needle)
1674 Push(Right, Needle):7	Release(Left, Needle):6	Push(Right, Needle):7	 ->Push(Right, Needle)
1675 Push(Right, Needle):7	Release(Left, Needle):6	Push(Right, Needle):7	 ->Push(Right, Needle)
1676 Push(Right, Needle):7	Release(Left, Needle):6	Push(Right, Needle):7	 ->Push(Right, Needle)
1677 Push(Right, Needle):7	Release(Left, Needle):6	Push(Right, Needle):7	 ->Push(Right, Needle)
1678 Push(Right, Needle):7	Release(Left, Needle):6	Push(Right, Needle):7	 ->Push(Right, Needle)
1679 Push(Right, Needle):7	Release(Left, Needle):6	Push(Right, Needle):7	 ->Push(Right, Needle)
1680 Push(Right, Needle):7	Release(Left, Needle):6	Push(Right, Needle):7	 ->Push(Right, Needle)
1681 Push(Right, Needle):7	Release(Left, Needle):6	Push(Right, Needle):7	 ->Push(Right, Needle)
1682 Push(Right, Needle):7	Release(Left, Needle):6	Push(Right, Needle):7	 ->Push(Right, Needle)
1683 Push(Right, Needle):7	Release(Left, Needle):6	Push(Right, Needle):7	 ->Push(Right, Needle)
1684 Push(Right, Needle):7	Release(Left, Needle):6	Push(Right, Needle):7	 ->Push(Right, Needle)
1685 Push(Right, Needle):7	Release(Left, Needle):6	Push(Right, Needle):7	 ->Push(Right, Needle)
1686 Push(Right, Needle):7	Release(Left, Needle):6	Push(Right, Needle):7	 ->Push(Right, Needle)
1687 Push(Right, Needle):7	Release(Left, Needle):6	Push(Right, Needle):7	 ->Push(Right, Needle)
1688 Push(Right, Needle):7	Release(Left, Needle):6	Push(Right, Needle):7	 ->Push(Right, Needle)
1689 Push(Right, Needle):7	Release(Left, Needle):6	Push(Right, Needle):7	 ->Push(Right, Needle)
1690 Push(Right, Needle):7	Release(Left, Needle):6	Push(Right, Needle):7	 ->Push(Right, Needle)
1691 Push(Right, Needle):7	Release(Left, Needle):6	Push(Right, Needle):7	 ->Push(Right, Needle)
1692 Push(Right, Needle):7	Release(Left, Needle):6	Push(Right, Needle):7	 ->Push(Right, Needle)
1693 Push(Right, Needle):7	Release(Left, Needle):6	Push(Right, Needle):7	 ->Push(Right, Needle)
1694 Push(Right, Needle):7	Release(Left, Needle):6	Push(Right, Needle):7	 ->Push(Right, Needle)
1695 Push(Right, Needle):7	Release(Left, Needle):6	Push(Right, Needle):7	 ->Push(Right, Needle)
1696 Push(Right, Needle):7	Release(Left, Needle):6	Push(Right, Needle):7	 ->Push(Right, Needle)
1697 Push(Right, Needle):7	Release(Left, Needle):6	Push(Right, Needle):7	 ->Push(Right, Needle)
1698 Push(Right, Needle):7	Release(Left, Needle):6	Push(Right, Needle):7	 ->Push(Right, Needle)
1699 Push(Right, Needle):7	Release(Left, Needle):6	Push(Right, Needle):7	 ->Push(Right, Needle)
1700 Push(Right, Needle):7	Release(Left, Needle):6	Push(Right, Needle):7	 ->Push(Right, Needle)
1701 Push(Right, Needle):7	Release(Left, Needle):6	Push(Right, Needle):7	 ->Push(Right, Needle)
1702 Push(Right, Needle):7	Release(Left, Needle):6	Push(Right, Needle):7	 ->Push(Right, Needle)
1703 Push(Right, Needle):7	Release(Left, Needle):6	Push(Right, Needle):7	 ->Push(Right, Needle)
1704 Push(Right, Needle):7	Push(Right, Needle):7	Push(Right, Needle):7	 ->Push(Right, Needle)
1705 Push(Right, Needle):7	Push(Right, Needle):7	Push(Right, Needle):7	 ->Push(Right, Needle)
1706 Push(Right, Needle):7	Push(Right, Needle):7	Push(Right, Needle):7	 ->Push(Right, Needle)
1707 Push(Right, Needle):7	Push(Right, Needle):7	Push(Right, Needle):7	 ->Push(Right, Needle)
1708 Push(Right, Needle):7	Push(Right, Needle):7	Push(Right, Needle):7	 ->Push(Right, Needle)
1709 Push(Right, Needle):7	Push(Right, Needle):7	Push(Right, Needle):7	 ->Push(Right, Needle)
1710 Push(Right, Needle):7	Push(Right, Needle):7	Push(Right, Needle):7	 ->Push(Right, Needle)
1711 Push(Right, Needle):7	Push(Right, Needle):7	Push(Right, Needle):7	 ->Push(Right, Needle)
1712 Push(Right, Needle):7	Push(Right, Needle):7	Push(Right, Needle):7	 ->Push(Right, Needle)
1713 Push(Right, Needle):7	Push(Right, Needle):7	Push(Right, Needle):7	 ->Push(Right, Needle)
1714 Push(Right, Needle):7	Push(Right, Needle):7	Push(Right, Needle):7	 ->Push(Right, Needle)
1715 Push(Right, Needle):7	Push(Right, Needle):7	Push(Right, Needle):7	 ->Push(Right, Needle)
1716 Push(Right, Needle):7	Push(Right, Needle):7	Push(Right, Needle):7	 ->Push(Right, Needle)
1717 Push(Right, Needle):7	Push(Right, Needle):7	Push(Right, Needle):7	 ->Push(Right, Needle)
1718 Push(Right, Needle):7	Push(Right, Needle):7	Push(Right, Needle):7	 ->Push(Right, Needle)
1719 Push(Right, Needle):7	Push(Right, Needle):7	Push(Right, Needle):7	 ->Push(Right, Needle)
1720 Push(Right, Needle):7	Push(Right, Needle):7	Push(Right, Needle):7	 ->Push(Right, Needle)
1721 Push(Right, Needle):7	Push(Right, Needle):7	Push(Right, Needle):7	 ->Push(Right, Needle)
1722 Push(Right, Needle):7	Push(Right, Needle):7	Push(Right, Needle):7	 ->Push(Right, Needle)
1723 Push(Right, Needle):7	Push(Right, Needle):7	Push(Right, Needle):7	 ->Push(Right, Needle)
1724 Push(Right, Needle):7	Push(Right, Needle):7	Push(Right, Needle):7	 ->Push(Right, Needle)
1725 Push(Right, Needle):7	Push(Right, Needle):7	Push(Right, Needle):7	 ->Push(Right, Needle)
1726 Push(Right, Needle):7	Push(Right, Needle):7	Push(Right, Needle):7	 ->Push(Right, Needle)
1727 Push(Right, Needle):7	Push(Right, Needle):7	Push(Right, Needle):7	 ->Push(Right, Needle)
1728 Push(Right, Needle):7	Push(Right, Needle):7	Push(Right, Needle):7	 ->Push(Right, Needle)
1729 Push(Right, Needle):7	Push(Right, Needle):7	Push(Right, Needle):7	 ->Push(Right, Needle)
1730 Push(Right, Needle):7	Push(Right, Needle):7	Push(Right, Needle):7	 ->Push(Right, Needle)
1731 Push(Right, Needle):7	Push(Right, Needle):7	Push(Right, Needle):7	 ->Push(Right, Needle)
1732 Push(Right, Needle):7	Push(Right, Needle):7	Push(Right, Needle):7	 ->Push(Right, Needle)
1733 Push(Right, Needle):7	Push(Right, Needle):7	Push(Right, Needle):7	 ->Push(Right, Needle)
1734 Push(Right, Needle):7	Push(Right, Needle):7	Touch(Left, Needle):4	 ->Push(Right, Needle)
1735 Push(Right, Needle):7	Push(Right, Needle):7	Touch(Left, Needle):4	 ->Push(Right, Needle)
1736 Push(Right, Needle):7	Push(Right, Needle):7	Touch(Left, Needle):4	 ->Push(Right, Needle)
1737 Push(Right, Needle):7	Push(Right, Needle):7	Touch(Left, Needle):4	 ->Push(Right, Needle)
1738 Push(Right, Needle):7	Push(Right, Needle):7	Touch(Left, Needle):4	 ->Push(Right, Needle)
1739 Push(Right, Needle):7	Push(Right, Needle):7	Touch(Left, Needle):4	 ->Push(Right, Needle)
1740 Push(Right, Needle):7	Push(Right, Needle):7	Touch(Left, Needle):4	 ->Push(Right, Needle)
1741 Push(Right, Needle):7	Push(Right, Needle):7	Touch(Left, Needle):4	 ->Push(Right, Needle)
1742 Push(Right, Needle):7	Push(Right, Needle):7	Touch(Left, Needle):4	 ->Push(Right, Needle)
1743 Push(Right, Needle):7	Push(Right, Needle):7	Touch(Left, Needle):4	 ->Push(Right, Needle)
1744 Push(Right, Needle):7	Push(Right, Needle):7	Touch(Left, Needle):4	 ->Push(Right, Needle)
1745 Push(Right, Needle):7	Push(Right, Needle):7	Touch(Left, Needle):4	 ->Push(Right, Needle)
1746 Push(Right, Needle):7	Push(Right, Needle):7	Touch(Left, Needle):4	 ->Push(Right, Needle)
1747 Push(Right, Needle):7	Push(Right, Needle):7	Touch(Left, Needle):4	 ->Push(Right, Needle)
1748 Push(Right, Needle):7	Push(Right, Needle):7	Touch(Left, Needle):4	 ->Push(Right, Needle)
1749 Grasp(Left, Needle):5	Push(Right, Needle):7	Touch(Left, Needle):4	 ->Grasp(Left, Needle)
1750 Grasp(Left, Needle):5	Push(Right, Needle):7	Touch(Left, Needle):4	 ->Grasp(Left, Needle)
1751 Grasp(Left, Needle):5	Push(Right, Needle):7	Touch(Left, Needle):4	 ->Grasp(Left, Needle)
1752 Grasp(Left, Needle):5	Push(Right, Needle):7	Touch(Left, Needle):4	 ->Grasp(Left, Needle)
1753 Grasp(Left, Needle):5	Push(Right, Needle):7	Touch(Left, Needle):4	 ->Grasp(Left, Needle)
1754 Grasp(Left, Needle):5	Push(Right, Needle):7	Touch(Left, Needle):4	 ->Grasp(Left, Needle)
1755 Grasp(Left, Needle):5	Push(Right, Needle):7	Touch(Left, Needle):4	 ->Grasp(Left, Needle)
1756 Grasp(Left, Needle):5	Push(Right, Needle):7	Touch(Left, Needle):4	 ->Grasp(Left, Needle)
1757 Grasp(Left, Needle):5	Push(Right, Needle):7	Touch(Left, Needle):4	 ->Grasp(Left, Needle)
1758 Grasp(Left, Needle):5	Push(Right, Needle):7	Touch(Left, Needle):4	 ->Grasp(Left, Needle)
1759 Grasp(Left, Needle):5	Push(Right, Needle):7	Touch(Left, Needle):4	 ->Grasp(Left, Needle)
1760 Grasp(Left, Needle):5	Push(Right, Needle):7	Touch(Left, Needle):4	 ->Grasp(Left, Needle)
1761 Grasp(Left, Needle):5	Push(Right, Needle):7	Touch(Left, Needle):4	 ->Grasp(Left, Needle)
1762 Grasp(Left, Needle):5	Push(Right, Needle):7	Touch(Left, Needle):4	 ->Grasp(Left, Needle)
1763 Grasp(Left, Needle):5	Push(Right, Needle):7	Touch(Left, Needle):4	 ->Grasp(Left, Needle)
1764 Grasp(Left, Needle):5	Push(Right, Needle):7	Touch(Left, Needle):4	 ->Grasp(Left, Needle)
1765 Grasp(Left, Needle):5	Push(Right, Needle):7	Touch(Left, Needle):4	 ->Grasp(Left, Needle)
1766 Grasp(Left, Needle):5	Push(Right, Needle):7	Touch(Left, Needle):4	 ->Grasp(Left, Needle)
1767 Grasp(Left, Needle):5	Push(Right, Needle):7	Touch(Left, Needle):4	 ->Grasp(Left, Needle)
1768 Grasp(Left, Needle):5	Push(Right, Needle):7	Touch(Left, Needle):4	 ->Grasp(Left, Needle)
1769 Grasp(Left, Needle):5	Push(Right, Needle):7	Touch(Left, Needle):4	 ->Grasp(Left, Needle)
1770 Grasp(Left, Needle):5	Push(Right, Needle):7	Touch(Left, Needle):4	 ->Grasp(Left, Needle)
1771 Grasp(Left, Needle):5	Push(Right, Needle):7	Touch(Left, Needle):4	 ->Grasp(Left, Needle)
1772 Grasp(Left, Needle):5	Push(Right, Needle):7	Touch(Left, Needle):4	 ->Grasp(Left, Needle)
1773 Grasp(Left, Needle):5	Push(Right, Needle):7	Touch(Left, Needle):4	 ->Grasp(Left, Needle)
1774 Grasp(Left, Needle):5	Push(Right, Needle):7	Touch(Left, Needle):4	 ->Grasp(Left, Needle)
1775 Grasp(Left, Needle):5	Push(Right, Needle):7	Touch(Left, Needle):4	 ->Grasp(Left, Needle)
1776 Grasp(Left, Needle):5	Push(Right, Needle):7	Touch(Left, Needle):4	 ->Grasp(Left, Needle)
1777 Grasp(Left, Needle):5	Push(Right, Needle):7	Grasp(Left, Needle):5	 ->Grasp(Left, Needle)
1778 Grasp(Left, Needle):5	Push(Right, Needle):7	Grasp(Left, Needle):5	 ->Grasp(Left, Needle)
1779 Grasp(Left, Needle):5	Push(Right, Needle):7	Grasp(Left, Needle):5	 ->Grasp(Left, Needle)
1780 Grasp(Left, Needle):5	Push(Right, Needle):7	Grasp(Left, Needle):5	 ->Grasp(Left, Needle)
1781 Grasp(Left, Needle):5	Push(Right, Needle):7	Grasp(Left, Needle):5	 ->Grasp(Left, Needle)
1782 Grasp(Left, Needle):5	Push(Right, Needle):7	Grasp(Left, Needle):5	 ->Grasp(Left, Needle)
1783 Grasp(Left, Needle):5	Push(Right, Needle):7	Grasp(Left, Needle):5	 ->Grasp(Left, Needle)
1784 Grasp(Left, Needle):5	Push(Right, Needle):7	Grasp(Left, Needle):5	 ->Grasp(Left, Needle)
1785 Grasp(Left, Needle):5	Push(Right, Needle):7	Grasp(Left, Needle):5	 ->Grasp(Left, Needle)
1786 Grasp(Left, Needle):5	Push(Right, Needle):7	Grasp(Left, Needle):5	 ->Grasp(Left, Needle)
1787 Grasp(Left, Needle):5	Push(Right, Needle):7	Grasp(Left, Needle):5	 ->Grasp(Left, Needle)
1788 Grasp(Left, Needle):5	Push(Right, Needle):7	Grasp(Left, Needle):5	 ->Grasp(Left, Needle)
1789 Grasp(Left, Needle):5	Push(Right, Needle):7	Release(Right, Needle):2	 ->Grasp(Left, Needle)
1790 Grasp(Left, Needle):5	Grasp(Left, Needle):5	Release(Right, Needle):2	 ->Grasp(Left, Needle)
1791 Grasp(Left, Needle):5	Grasp(Left, Needle):5	Release(Right, Needle):2	 ->Grasp(Left, Needle)
1792 Grasp(Left, Needle):5	Grasp(Left, Needle):5	Untouch(Right, Needle):3	 ->Grasp(Left, Needle)
1793 Grasp(Left, Needle):5	Grasp(Left, Needle):5	Untouch(Right, Needle):3	 ->Grasp(Left, Needle)
1794 Grasp(Left, Needle):5	Release(Right, Needle):2	Untouch(Right, Needle):3	 ->Grasp(Left, Needle)
1795 Grasp(Left, Needle):5	Release(Right, Needle):2	Untouch(Right, Needle):3	 ->Grasp(Left, Needle)
1796 Grasp(Left, Needle):5	Release(Right, Needle):2	Untouch(Right, Needle):3	 ->Grasp(Left, Needle)
1797 Grasp(Left, Needle):5	Pull(Left, Needle):9	Untouch(Right, Needle):3	 ->Grasp(Left, Needle)
1798 Grasp(Left, Needle):5	Pull(Left, Needle):9	Untouch(Right, Needle):3	 ->Grasp(Left, Needle)
1799 Grasp(Left, Needle):5	Pull(Left, Needle):9	Pull(Left, Needle):9	 ->Pull(Left, Needle)
1800 Grasp(Left, Needle):5	Pull(Left, Needle):9	Pull(Left, Needle):9	 ->Pull(Left, Needle)
1801 Grasp(Left, Needle):5	Pull(Left, Needle):9	Pull(Left, Needle):9	 ->Pull(Left, Needle)
1802 Grasp(Left, Needle):5	Pull(Left, Needle):9	Pull(Left, Needle):9	 ->Pull(Left, Needle)
1803 Grasp(Left, Needle):5	Pull(Left, Needle):9	Pull(Left, Needle):9	 ->Pull(Left, Needle)
1804 Grasp(Left, Needle):5	Pull(Left, Needle):9	Pull(Left, Needle):9	 ->Pull(Left, Needle)
1805 Grasp(Left, Needle):5	Pull(Left, Needle):9	Pull(Left, Needle):9	 ->Pull(Left, Needle)
1806 Grasp(Left, Needle):5	Pull(Left, Needle):9	Pull(Left, Needle):9	 ->Pull(Left, Needle)
1807 Grasp(Left, Needle):5	Pull(Left, Needle):9	Pull(Left, Needle):9	 ->Pull(Left, Needle)
1808 Grasp(Left, Needle):5	Pull(Left, Needle):9	Pull(Left, Needle):9	 ->Pull(Left, Needle)
1809 Grasp(Left, Needle):5	Pull(Left, Needle):9	Pull(Left, Needle):9	 ->Pull(Left, Needle)
1810 Grasp(Left, Needle):5	Pull(Left, Needle):9	Pull(Left, Needle):9	 ->Pull(Left, Needle)
1811 Grasp(Left, Needle):5	Pull(Left, Needle):9	Pull(Left, Needle):9	 ->Pull(Left, Needle)
1812 Grasp(Left, Needle):5	Pull(Left, Needle):9	Pull(Left, Needle):9	 ->Pull(Left, Needle)
1813 Grasp(Left, Needle):5	Pull(Left, Needle):9	Pull(Left, Needle):9	 ->Pull(Left, Needle)
1814 Grasp(Left, Needle):5	Pull(Left, Needle):9	Pull(Left, Needle):9	 ->Pull(Left, Needle)
1815 Grasp(Left, Needle):5	Pull(Left, Needle):9	Pull(Left, Needle):9	 ->Pull(Left, Needle)
1816 Pull(Left, Needle):9	Pull(Left, Needle):9	Pull(Left, Needle):9	 ->Pull(Left, Needle)
1817 Pull(Left, Needle):9	Pull(Left, Needle):9	Pull(Left, Needle):9	 ->Pull(Left, Needle)
1818 Pull(Left, Needle):9	Pull(Left, Needle):9	Pull(Left, Needle):9	 ->Pull(Left, Needle)
1819 Pull(Left, Needle):9	Pull(Left, Needle):9	Pull(Left, Needle):9	 ->Pull(Left, Needle)
1820 Pull(Left, Needle):9	Pull(Left, Needle):9	Pull(Left, Needle):9	 ->Pull(Left, Needle)
1821 Pull(Left, Needle):9	Pull(Left, Needle):9	Pull(Left, Needle):9	 ->Pull(Left, Needle)
1822 Pull(Left, Needle):9	Pull(Left, Needle):9	Pull(Left, Needle):9	 ->Pull(Left, Needle)
1823 Pull(Left, Needle):9	Pull(Left, Needle):9	Pull(Left, Needle):9	 ->Pull(Left, Needle)
1824 Pull(Left, Needle):9	Pull(Left, Needle):9	Pull(Left, Needle):9	 ->Pull(Left, Needle)
1825 Pull(Left, Needle):9	Pull(Left, Needle):9	Pull(Left, Needle):9	 ->Pull(Left, Needle)
1826 Pull(Left, Needle):9	Pull(Left, Needle):9	Pull(Left, Needle):9	 ->Pull(Left, Needle)
1827 Pull(Left, Needle):9	Pull(Left, Needle):9	Pull(Left, Needle):9	 ->Pull(Left, Needle)
1828 Pull(Left, Needle):9	Pull(Left, Needle):9	Pull(Left, Needle):9	 ->Pull(Left, Needle)
1829 Pull(Left, Needle):9	Pull(Left, Needle):9	Pull(Left, Needle):9	 ->Pull(Left, Needle)
1830 Pull(Left, Needle):9	Pull(Left, Needle):9	Pull(Left, Needle):9	 ->Pull(Left, Needle)
1831 Pull(Left, Needle):9	Pull(Left, Needle):9	Pull(Left, Needle):9	 ->Pull(Left, Needle)
1832 Pull(Left, Needle):9	Pull(Left, Needle):9	Pull(Left, Needle):9	 ->Pull(Left, Needle)
1833 Pull(Left, Needle):9	Pull(Left, Needle):9	Pull(Left, Needle):9	 ->Pull(Left, Needle)
1834 Pull(Left, Needle):9	Pull(Left, Needle):9	Pull(Left, Needle):9	 ->Pull(Left, Needle)
1835 Pull(Left, Needle):9	Pull(Left, Needle):9	Pull(Left, Needle):9	 ->Pull(Left, Needle)
1836 Pull(Left, Needle):9	Pull(Left, Needle):9	Pull(Left, Needle):9	 ->Pull(Left, Needle)
1837 Pull(Left, Needle):9	Pull(Left, Needle):9	Pull(Left, Needle):9	 ->Pull(Left, Needle)
1838 Pull(Left, Needle):9	Pull(Left, Needle):9	Pull(Left, Needle):9	 ->Pull(Left, Needle)
1839 Pull(Left, Needle):9	Pull(Left, Needle):9	Pull(Left, Needle):9	 ->Pull(Left, Needle)
1840 Pull(Left, Needle):9	Pull(Left, Needle):9	Pull(Left, Needle):9	 ->Pull(Left, Needle)
1841 Pull(Left, Needle):9	Pull(Left, Needle):9	Pull(Left, Needle):9	 ->Pull(Left, Needle)
1842 Pull(Left, Needle):9	Pull(Left, Needle):9	Pull(Left, Needle):9	 ->Pull(Left, Needle)
1843 Pull(Left, Needle):9	Pull(Left, Needle):9	Pull(Left, Needle):9	 ->Pull(Left, Needle)
1844 Pull(Left, Needle):9	Pull(Left, Needle):9	Pull(Left, Needle):9	 ->Pull(Left, Needle)
1845 Pull(Left, Needle):9	Pull(Left, Needle):9	Pull(Left, Needle):9	 ->Pull(Left, Needle)
1846 Pull(Left, Needle):9	Pull(Left, Needle):9	Pull(Left, Needle):9	 ->Pull(Left, Needle)
1847 Pull(Left, Needle):9	Pull(Left, Needle):9	Pull(Left, Needle):9	 ->Pull(Left, Needle)
1848 Pull(Left, Needle):9	Pull(Left, Needle):9	Pull(Left, Needle):9	 ->Pull(Left, Needle)
1849 Pull(Left, Needle):9	Pull(Left, Needle):9	Pull(Left, Needle):9	 ->Pull(Left, Needle)
1850 Pull(Left, Needle):9	Pull(Left, Needle):9	Pull(Left, Needle):9	 ->Pull(Left, Needle)
1851 Pull(Left, Needle):9	Pull(Left, Needle):9	Pull(Left, Needle):9	 ->Pull(Left, Needle)
1852 Pull(Left, Needle):9	Pull(Left, Needle):9	Pull(Left, Needle):9	 ->Pull(Left, Needle)
1853 Pull(Left, Needle):9	Pull(Left, Needle):9	Pull(Left, Needle):9	 ->Pull(Left, Needle)
1854 Pull(Left, Needle):9	Pull(Left, Needle):9	Pull(Left, Needle):9	 ->Pull(Left, Needle)
1855 Pull(Left, Needle):9	Pull(Left, Needle):9	Pull(Left, Needle):9	 ->Pull(Left, Needle)
1856 Pull(Left, Needle):9	Pull(Left, Needle):9	Pull(Left, Needle):9	 ->Pull(Left, Needle)
1857 Pull(Left, Needle):9	Pull(Left, Needle):9	Pull(Left, Needle):9	 ->Pull(Left, Needle)
1858 Pull(Left, Needle):9	Pull(Left, Needle):9	Pull(Left, Needle):9	 ->Pull(Left, Needle)
1859 Pull(Left, Needle):9	Pull(Left, Needle):9	Pull(Left, Needle):9	 ->Pull(Left, Needle)
1860 Pull(Left, Needle):9	Pull(Left, Needle):9	Pull(Left, Needle):9	 ->Pull(Left, Needle)
1861 Pull(Left, Needle):9	Pull(Left, Needle):9	Pull(Left, Needle):9	 ->Pull(Left, Needle)
1862 Pull(Left, Needle):9	Pull(Left, Needle):9	Pull(Left, Needle):9	 ->Pull(Left, Needle)
1863 Pull(Left, Needle):9	Pull(Left, Needle):9	Pull(Left, Needle):9	 ->Pull(Left, Needle)
1864 Pull(Left, Needle):9	Pull(Left, Needle):9	Pull(Left, Needle):9	 ->Pull(Left, Needle)
1865 Pull(Left, Needle):9	Pull(Left, Needle):9	Pull(Left, Needle):9	 ->Pull(Left, Needle)
1866 Pull(Left, Needle):9	Pull(Left, Needle):9	Pull(Left, Needle):9	 ->Pull(Left, Needle)
1867 Pull(Left, Needle):9	Pull(Left, Needle):9	Pull(Left, Needle):9	 ->Pull(Left, Needle)
1868 Pull(Left, Needle):9	Pull(Left, Needle):9	Pull(Left, Needle):9	 ->Pull(Left, Needle)
1869 Pull(Left, Needle):9	Pull(Left, Needle):9	Pull(Left, Needle):9	 ->Pull(Left, Needle)
1870 Pull(Left, Needle):9	Pull(Left, Needle):9	Pull(Left, Needle):9	 ->Pull(Left, Needle)
1871 Pull(Left, Needle):9	Pull(Left, Needle):9	Pull(Left, Needle):9	 ->Pull(Left, Needle)
1872 Pull(Left, Needle):9	Pull(Left, Needle):9	Pull(Left, Needle):9	 ->Pull(Left, Needle)
1873 Pull(Left, Needle):9	Pull(Left, Needle):9	Pull(Left, Needle):9	 ->Pull(Left, Needle)
1874 Pull(Left, Needle):9	Pull(Left, Needle):9	Pull(Left, Needle):9	 ->Pull(Left, Needle)
1875 Pull(Left, Needle):9	Pull(Left, Needle):9	Pull(Left, Needle):9	 ->Pull(Left, Needle)
1876 Pull(Left, Needle):9	Pull(Left, Needle):9	Pull(Left, Needle):9	 ->Pull(Left, Needle)
1877 Pull(Left, Needle):9	Pull(Left, Needle):9	Pull(Left, Needle):9	 ->Pull(Left, Needle)
1878 Pull(Left, Needle):9	Pull(Left, Needle):9	Pull(Left, Needle):9	 ->Pull(Left, Needle)
1879 Pull(Left, Needle):9	Pull(Left, Needle):9	Pull(Left, Needle):9	 ->Pull(Left, Needle)
1880 Pull(Left, Needle):9	Pull(Left, Needle):9	Pull(Left, Needle):9	 ->Pull(Left, Needle)
1881 Pull(Left, Needle):9	Pull(Left, Needle):9	Pull(Left, Needle):9	 ->Pull(Left, Needle)
1882 Pull(Left, Needle):9	Pull(Left, Needle):9	Pull(Left, Needle):9	 ->Pull(Left, Needle)
1883 Pull(Left, Needle):9	Pull(Left, Needle):9	Pull(Left, Needle):9	 ->Pull(Left, Needle)
1884 Pull(Left, Needle):9	Pull(Left, Needle):9	Pull(Left, Needle):9	 ->Pull(Left, Needle)
1885 Pull(Left, Needle):9	Pull(Left, Needle):9	Pull(Left, Needle):9	 ->Pull(Left, Needle)
1886 Pull(Left, Needle):9	Pull(Left, Needle):9	Pull(Left, Needle):9	 ->Pull(Left, Needle)
1887 Pull(Left, Needle):9	Pull(Left, Needle):9	Pull(Left, Needle):9	 ->Pull(Left, Needle)
1888 Pull(Left, Needle):9	Pull(Left, Needle):9	Pull(Left, Needle):9	 ->Pull(Left, Needle)
1889 Pull(Left, Needle):9	Pull(Left, Needle):9	Pull(Left, Needle):9	 ->Pull(Left, Needle)
1890 Pull(Left, Needle):9	Pull(Left, Needle):9	Pull(Left, Needle):9	 ->Pull(Left, Needle)
1891 Pull(Left, Needle):9	Pull(Left, Needle):9	Pull(Left, Needle):9	 ->Pull(Left, Needle)
1892 Pull(Left, Needle):9	Pull(Left, Needle):9	Pull(Left, Needle):9	 ->Pull(Left, Needle)
1893 Pull(Left, Needle):9	Pull(Left, Needle):9	Pull(Left, Needle):9	 ->Pull(Left, Needle)
1894 Pull(Left, Needle):9	Pull(Left, Needle):9	Pull(Left, Needle):9	 ->Pull(Left, Needle)
1895 Pull(Left, Needle):9	Pull(Left, Needle):9	Pull(Left, Needle):9	 ->Pull(Left, Needle)
1896 Pull(Left, Needle):9	Pull(Left, Needle):9	Pull(Left, Needle):9	 ->Pull(Left, Needle)
1897 Pull(Left, Needle):9	Pull(Left, Needle):9	Pull(Left, Needle):9	 ->Pull(Left, Needle)
1898 Pull(Left, Needle):9	Pull(Left, Needle):9	Pull(Left, Needle):9	 ->Pull(Left, Needle)
1899 Pull(Left, Needle):9	Pull(Left, Needle):9	Pull(Left, Needle):9	 ->Pull(Left, Needle)
1900 Pull(Left, Needle):9	Pull(Left, Needle):9	Pull(Left, Needle):9	 ->Pull(Left, Needle)
1901 Pull(Left, Needle):9	Pull(Left, Needle):9	Pull(Left, Needle):9	 ->Pull(Left, Needle)
1902 Pull(Left, Needle):9	Pull(Left, Needle):9	Pull(Left, Needle):9	 ->Pull(Left, Needle)
1903 Pull(Left, Needle):9	Pull(Left, Needle):9	Pull(Left, Needle):9	 ->Pull(Left, Needle)
1904 Pull(Left, Needle):9	Pull(Left, Needle):9	Pull(Left, Needle):9	 ->Pull(Left, Needle)
1905 Pull(Left, Needle):9	Pull(Left, Needle):9	Pull(Left, Needle):9	 ->Pull(Left, Needle)
1906 Pull(Left, Needle):9	Pull(Left, Needle):9	Pull(Left, Needle):9	 ->Pull(Left, Needle)
1907 Pull(Left, Needle):9	Pull(Left, Needle):9	Pull(Left, Needle):9	 ->Pull(Left, Needle)
1908 Pull(Left, Needle):9	Pull(Left, Needle):9	Pull(Left, Needle):9	 ->Pull(Left, Needle)
1909 Pull(Left, Needle):9	Pull(Left, Needle):9	Pull(Left, Needle):9	 ->Pull(Left, Needle)
1910 Pull(Left, Needle):9	Pull(Left, Needle):9	Pull(Left, Needle):9	 ->Pull(Left, Needle)
1911 Pull(Left, Needle):9	Pull(Left, Needle):9	Pull(Left, Needle):9	 ->Pull(Left, Needle)
1912 Pull(Left, Needle):9	Pull(Left, Needle):9	Pull(Left, Needle):9	 ->Pull(Left, Needle)
1913 Pull(Left, Needle):9	Pull(Left, Needle):9	Pull(Left, Needle):9	 ->Pull(Left, Needle)
1914 Pull(Left, Needle):9	Pull(Left, Needle):9	Pull(Left, Needle):9	 ->Pull(Left, Needle)
1915 Pull(Left, Needle):9	Pull(Left, Needle):9	Pull(Left, Needle):9	 ->Pull(Left, Needle)
1916 Pull(Left, Needle):9	Pull(Left, Needle):9	Pull(Left, Needle):9	 ->Pull(Left, Needle)
1917 Pull(Left, Needle):9	Pull(Left, Needle):9	Pull(Left, Needle):9	 ->Pull(Left, Needle)
1918 Pull(Left, Needle):9	Pull(Left, Needle):9	Pull(Left, Needle):9	 ->Pull(Left, Needle)
1919 Pull(Left, Needle):9	Pull(Left, Needle):9	Pull(Left, Needle):9	 ->Pull(Left, Needle)
1920 Pull(Left, Needle):9	Pull(Left, Needle):9	Pull(Left, Needle):9	 ->Pull(Left, Needle)
1921 Pull(Left, Needle):9	Pull(Left, Needle):9	Pull(Left, Needle):9	 ->Pull(Left, Needle)
1922 Pull(Left, Needle):9	Pull(Left, Needle):9	Pull(Left, Needle):9	 ->Pull(Left, Needle)
1923 Pull(Left, Needle):9	Pull(Left, Needle):9	Pull(Left, Needle):9	 ->Pull(Left, Needle)
1924 Pull(Left, Needle):9	Pull(Left, Needle):9	Pull(Left, Needle):9	 ->Pull(Left, Needle)
1925 Pull(Left, Needle):9	Pull(Left, Needle):9	Pull(Left, Needle):9	 ->Pull(Left, Needle)
1926 Pull(Left, Needle):9	Pull(Left, Needle):9	Pull(Left, Needle):9	 ->Pull(Left, Needle)
1927 Pull(Left, Needle):9	Pull(Left, Needle):9	Pull(Left, Needle):9	 ->Pull(Left, Needle)
1928 Pull(Left, Needle):9	Pull(Left, Needle):9	Pull(Left, Needle):9	 ->Pull(Left, Needle)
1929 Pull(Left, Needle):9	Pull(Left, Needle):9	Pull(Left, Needle):9	 ->Pull(Left, Needle)
1930 Pull(Left, Needle):9	Pull(Left, Needle):9	Pull(Left, Needle):9	 ->Pull(Left, Needle)
1931 Pull(Left, Needle):9	Pull(Left, Needle):9	Pull(Left, Needle):9	 ->Pull(Left, Needle)
1932 Pull(Left, Needle):9	Pull(Left, Needle):9	Pull(Left, Needle):9	 ->Pull(Left, Needle)
1933 Pull(Left, Needle):9	Pull(Left, Needle):9	Pull(Left, Needle):9	 ->Pull(Left, Needle)
1934 Pull(Left, Needle):9	Pull(Left, Needle):9	Pull(Left, Needle):9	 ->Pull(Left, Needle)
1935 Pull(Left, Needle):9	Pull(Left, Needle):9	Pull(Left, Needle):9	 ->Pull(Left, Needle)
1936 Pull(Left, Needle):9	Release(Left, Needle):6	Pull(Left, Needle):9	 ->Pull(Left, Needle)
1937 Pull(Left, Needle):9	Release(Left, Needle):6	Pull(Left, Needle):9	 ->Pull(Left, Needle)
1938 Pull(Left, Needle):9	Release(Left, Needle):6	Pull(Left, Needle):9	 ->Pull(Left, Needle)
1939 Pull(Left, Needle):9	Release(Left, Needle):6	Pull(Left, Needle):9	 ->Pull(Left, Needle)
1940 Pull(Left, Needle):9	Release(Left, Needle):6	Pull(Left, Needle):9	 ->Pull(Left, Needle)
1941 Pull(Left, Needle):9	Release(Left, Needle):6	Pull(Left, Needle):9	 ->Pull(Left, Needle)
1942 Pull(Left, Needle):9	Release(Left, Needle):6	Pull(Left, Needle):9	 ->Pull(Left, Needle)
1943 Pull(Left, Needle):9	Release(Left, Needle):6	Pull(Left, Needle):9	 ->Pull(Left, Needle)
1944 Pull(Left, Needle):9	Release(Left, Needle):6	Pull(Left, Needle):9	 ->Pull(Left, Needle)
1945 Pull(Left, Needle):9	Release(Left, Needle):6	Pull(Left, Needle):9	 ->Pull(Left, Needle)
1946 Pull(Left, Needle):9	Release(Left, Needle):6	Pull(Left, Needle):9	 ->Pull(Left, Needle)
1947 Pull(Left, Needle):9	Release(Left, Needle):6	Pull(Left, Needle):9	 ->Pull(Left, Needle)
1948 Pull(Left, Needle):9	Release(Left, Needle):6	Pull(Left, Needle):9	 ->Pull(Left, Needle)
1949 Pull(Left, Needle):9	Release(Left, Needle):6	Pull(Left, Needle):9	 ->Pull(Left, Needle)
1950 Pull(Left, Needle):9	Release(Left, Needle):6	Pull(Left, Needle):9	 ->Pull(Left, Needle)
1951 Pull(Left, Needle):9	Release(Left, Needle):6	Pull(Left, Needle):9	 ->Pull(Left, Needle)
1952 Pull(Left, Needle):9	Release(Left, Needle):6	Pull(Left, Needle):9	 ->Pull(Left, Needle)
1953 Pull(Left, Needle):9	Release(Left, Needle):6	Pull(Left, Needle):9	 ->Pull(Left, Needle)
1954 Pull(Left, Needle):9	Release(Left, Needle):6	Pull(Left, Needle):9	 ->Pull(Left, Needle)
1955 Pull(Left, Needle):9	Release(Left, Needle):6	Pull(Left, Needle):9	 ->Pull(Left, Needle)
1956 Pull(Left, Needle):9	Release(Left, Needle):6	Pull(Left, Needle):9	 ->Pull(Left, Needle)
1957 Pull(Left, Needle):9	Release(Left, Needle):6	Pull(Left, Needle):9	 ->Pull(Left, Needle)
1958 Pull(Left, Needle):9	Release(Left, Needle):6	Pull(Left, Needle):9	 ->Pull(Left, Needle)
1959 Pull(Left, Needle):9	Release(Left, Needle):6	Pull(Left, Needle):9	 ->Pull(Left, Needle)
1960 Pull(Left, Needle):9	Release(Left, Needle):6	Pull(Left, Needle):9	 ->Pull(Left, Needle)
